id,wo num, wodetails,contractor,brnumber,amount,nett,deduction
12339,R-192-14-000010,PRVD IMPTS TO C/R OF CHAMUNDESHWARI NAGAR L/O IN WARD NO 146,KRIDL9448612351,BR - 000149 / 30-Jun-2014CBR - 001989 / 06-Jun-2016Rtgs - 000049 / 09-Jun-2016,3832434,2367289,1465145
11639,192-14-000017,Improvements to roads at Mohan Layout in ward No 192 Begur,N Jagadish9342540302,BR - 000150 / 30-Jun-2014CBR - 001993 / 06-Jun-2016Rtgs - 000049 / 09-Jun-2016,993623,861860,131763
12473,192-13-000016,IMPROVEMENTS OF ROADS AT AK COLONY IN BEGUR VILLAGE IN WARD NO 192 BEGUR,Pratish Kumar S R 9972188889,BR - 000053 / 30-Apr-2014CBR - 002440 / 13-Jun-2016Rtgs - 000056 / 15-Jun-2016,1043490,891165,152325
9114,192-14-000002,Filling of pot holes in ward No 192 Begur,Venkatakrishna 1234567890,BR - 000160 / 30-Jul-2014CBR - 002594 / 16-Jun-2016Rtgs - 000060 / 18-Jun-2016,1444186,1248468,195718
12474,192-14-000023,Annual Maintenance of ward area in ward No 192 Begur,Venkatakrishna9141648915,BR - 000161 / 31-Jul-2014CBR - 002673 / 17-Jun-2016Rtgs - 000066 / 23-Jun-2016,667058,582658,84400
13382,192-14-000005,Supplying drinking water through tankers in East side of Begur ward No 192 Begur,A Francis 9036718749,BR - 000201 / 31-Jul-2014CBR - 002754 / 18-Jun-2016Rtgs - 000066 / 23-Jun-2016,1046350,919185,127165
9417,192-13-000102,Providing additional street light fittings and control switches doddakammanahalli Chikka Kammanahalli Basavanapura Kalena agrahara Tejaswini Nagara and connected area in ward no 192,"TECHNICAL MANAGER-01 , KRIDL9945510720",BR - 000074 / 31-Aug-2013CBR - 003042 / 22-Jun-2016Rtgs - 000071 / 02-Jul-2016,2746252,2337052,409200
13379,192-13-000005,IMPROVEMENTS TO ROADS CHIKKA KAMMANAHALLI VILLAGE IN WARD NO 192 BEGUR,A Francis 9036718749,BR - 000287 / 30-Aug-2014CBR - 003713 / 14-Jul-2016Rtgs - 000082 / 20-Jul-2016,1047780,899615,148165
12241,192-12-000038,ENGAGING TRACTOR AND LABOURS TO REMOVAL OF ROAD SIDE DEBRIES IN BEGUR WARD NO 192,G Nagarajareddy9739163616,BR - 000030 / 30-Aug-2014CBR - 004114 / 28-Jul-2016Rtgs - 000091 / 03-Aug-2016,258598,217676,40922
12246,192-12-000037,EMERGENCY AND SECURITY WORKS IN WARD NO 192,G Nagarajareddy9739163616,BR - 000031 / 30-Aug-2014CBR - 004115 / 28-Jul-2016Rtgs - 000091 / 03-Aug-2016,291675,243962,47713
11361,192-13-000007,PROVIDING RCC DRAIN AT BASAVANAPURA VILLAGE NEAR MATHUYES RESIDENCE IN WARD NO 192 BEGUR,K Hanumantappa9845511104,BR - 000300 / 30-Sep-2014CBR - 004571 / 12-Aug-2016Rtgs - 000107 / 24-Aug-2016,1561100,1350376,210724
13228,192-11-000001,Improvements to roads of Doddakammanahalli village in ward No 192,G Nagaraja Reddy9492804401,BR - 000320 / 30-Sep-2014CBR - 004578 / 12-Aug-2016Rtgs - 000107 / 24-Aug-2016,1038030,863823,174207
13223,192-11-000006,Improvements to roads of Begur Village in ward No 192,G Nagarajareddy9986007428,BR - 000322 / 30-Sep-2014CBR - 004579 / 12-Aug-2016Rtgs - 000107 / 24-Aug-2016,1571880,1319047,252833
46528,192-16-000028,Development and improvements to roads and drains in main road and cross roads of ward No 192 Begur.,KRIDL9448489352,BR - 000140 / 12-Sep-2016CBR - 005587 / 17-Oct-2016Rtgs - 000130 / 18-Oct-2016,6389370,5395690,993680
14025,192-14-000014,Improvements to road at Chikka Begur in ward No 192 Begur,K S Ramu9900145168,BR - 000344 / 24-Nov-2014CBR - 006123 / 20-Dec-2016Rtgs - 000157 / 23-Dec-2016,1039960,896866,143094
15671,192-14-000015,Providing RCC Drain at Basavanapura main road in ward No 192 Begur,K Balaiah9945060116,BR - 000393 / 29-Nov-2014CBR - 006275 / 26-Dec-2016Rtgs - 000161 / 28-Dec-2016,985900,858450,127450
5537,192-14-000062,Maintenance of Borewells in ward No 192 ,KRIDL9448489352,BR - 000155 / 06-Oct-2015CBR - 006616 / 16-Jan-2017Rtgs - 000178 / 28-Jan-2017,1497000,1252505,244495
54414,192-16-000021,Drilling of Borewells and fixing of pump and motors in various areas of Begur villagein Ward No 192 Begur,KRIDL9980795596,BR - 000198 / 28-Oct-2016CBR - 007101 / 03-Feb-2017Rtgs - 000182 / 04-Feb-2017,4820860,4115030,705830
54393,192-16-000022,Drilling of Borewells and fixing of pump and motors in various areas in Chikka Begur village Ward No 192 Begur,KRIDL9980795596,BR - 000197 / 28-Oct-2016CBR - 007102 / 03-Feb-2017Rtgs - 000182 / 04-Feb-2017,4800270,4097230,703040
54422,192-16-000025,Drilling of Borewells and fixing of pump and motors in Bertena agrahara and Basavanapura and various areas in Ward No 192 Begur,KRIDL9845019972,BR - 000195 / 28-Oct-2016CBR - 007105 / 04-Feb-2017Rtgs - 000182 / 04-Feb-2017,4851100,4140430,710670
55957,192-16-000020,Improvements to roads in Duo heights layout Begur in Ward No 192,VINOD KUMAR B K8884572139,BR - 0231/D / 31-Dec-2016CBR - 007111 / 07-Feb-2017Rtgs - 000186 / 10-Feb-2017,4476730,4067090,409640
55699,192-16-000014,Improvements of Vishwapriya layout main road from Begur main road to Chikkabegur boundary in Ward No 192,VINOD KUMAR B K8884572139,BR - 0231/E / 30-Dec-2016CBR - 007112 / 07-Feb-2017Rtgs - 000186 / 10-Feb-2017,5050960,4588820,462140
55913,192-16-000019,Improvements to MLA layout main road from Bannerughatta road to SWD at Kalena agrahara in Ward No 192,VINOD KUMAR B K8884572139,BR - 0231/C / 30-Dec-2016CBR - 007113 / 07-Feb-2017Rtgs - 000186 / 10-Feb-2017,6085820,5529020,556800
55884,192-16-000016,Improvements to Basavanapura main road from bannerughatta road to overhead tank in Ward No 192,VINOD KUMAR B K8884572139,BR - 0231/A / 30-Dec-2016CBR - 007114 / 07-Feb-2017Rtgs - 000186 / 10-Feb-2017,1613605,1482055,131550
55905,192-16-000018,Improvements to road from Chikkakammanahalli over head tank to Nice road bridge in Ward No 192,VINOD KUMAR B K8884572139,BR - 0231/B / 31-Dec-2016CBR - 007115 / 07-Feb-2017Rtgs - 000186 / 10-Feb-2017,7447300,6765700,681600
66025,192-16-000027,Construction of lead of drain and remodeling of Storm Water drain joining Beguru doddakere from Subhash nagara BH-568 in Begur ward (ward no.192) ,Sri. Veera vasu9449680044,BR - 000270 / 16-Jan-2017CBR - 007184 / 10-Feb-2017Rtgs - 000187 / 13-Feb-2017,14813400,13807400,1006000
15959,192-14-000070,Providing Asphalting to road from Naganathapura temple to Begur tank bund road in ward no 192,KRIDL8105654121,BR - 000460 / 22-Jan-2015CBR - 007232 / 13-Feb-2017Rtgs - 000190 / 17-Feb-2017,2199625,1841175,358450
651,192-14-000024,"Supplying drinking water through tankers in Subhash Nagara, Basapura, Chikka Thoguru, Chikka Begur side of Begur ward No 192 Begur",Francis A 9448489352,BR - 000478 / 31-Jan-2015CBR - 007389 / 20-Feb-2017Rtgs - 000195 / 22-Feb-2017,1425125,1244835,180290
15951,192-14-000025,Supplying drinking water through tankers in Begur and other layouts side of Begur ward No 192 Begur,H M Munikrishna9980795596,BR - 000489 / 31-Jan-2015CBR - 007390 / 20-Feb-2017Rtgs - 000195 / 22-Feb-2017,1572000,1364215,207785
9881,192-15-000008,Construction of culverts and Improvements to roads in Lakshmi Layout near Vittasandra road of ward No 192 Begur,V T Mahesh9886827056,BR - 000518 / 28-Feb-2015CBR - 007851 / 01-Mar-2017Rtgs - 000207 / 06-Mar-2017,1531340,1324765,206575
15950,192-14-000024,"Supplying drinking water through tankers in Subhash Nagara, Basapura, Chikka Thoguru, Chikka Begur side of Begur ward No 192 Begur",Francis A 9448489352,BR - 000534 / 23-Mar-2015CBR - 008212 / 14-Mar-2017Rtgs - 000216 / 16-Mar-2017,147225,129335,17890
76148,192-16-000019,Improvements to MLA layout main road from Bannerughatta road to SWD at Kalena agrahara in Ward No 192,VINOD KUMAR B K8884572139,BR - 00282C / 28-Feb-2017CBR - 000296 / 15-Apr-2017Rtgs - 000012 / 17-Apr-2017,57940,49240,8700
76115,192-16-000014,Improvements of Vishwapriya layout main road from Begur main road to Chikkabegur boundary in Ward No 192,VINOD KUMAR B K8884572139,BR - 00282A / 28-Feb-2017CBR - 000297 / 15-Apr-2017Rtgs - 000012 / 17-Apr-2017,269320,243510,25810
76150,192-16-000016,Improvements to Basavanapura main road from bannerughatta road to overhead tank in Ward No 192,VINOD KUMAR B K8884572139,BR - 00282B / 28-Feb-2017CBR - 000298 / 15-Apr-2017Rtgs - 000012 / 17-Apr-2017,2839670,2577360,262310
76130,192-16-000018,Improvements to road from Chikkakammanahalli over head tank to Nice road bridge in Ward No 192,VINOD KUMAR B K8884572139,BR - 00282E / 28-Feb-2017CBR - 000299 / 15-Apr-2017Rtgs - 000012 / 17-Apr-2017,50370,45010,5360
10040,192-13-000095,Drilling of Borewells and Errection of pump set at North side in ward no 192,KRIDL9739163616,BR - 000479 / 31-Jan-2015CBR - 000361 / 17-Apr-2017Rtgs - 000027 / 22-Apr-2017,1978955,1656910,322045
10042,192-13-000096,Drilling of Borewells and Errection of pump set at South side in ward no 192,KRIDL9739163616,BR - 000480 / 31-Jan-2015CBR - 000362 / 17-Apr-2017Rtgs - 000027 / 22-Apr-2017,1060410,888140,172270
10043,192-13-000099,Errection of Pump and Motor to borewlls in East side of ward no 192,KRIDL9739163616,BR - 000481 / 31-Jan-2015CBR - 000363 / 17-Apr-2017Rtgs - 000027 / 22-Apr-2017,1512445,1266755,245690
76153,192-16-000020,Improvements to roads in Duo heights layout Begur in Ward No 192,VINOD KUMAR B K8884572139,BR - 00282D / 28-Feb-2017CBR - 000551 / 21-Apr-2017Rtgs - 000029 / 24-Apr-2017,95820,73870,21950
76147,192-16-000015,Improvements to subhash nagara main road from Manipal county road to maseedi road in ward No 192,VINOD KUMAR B K8884572139,BR - 0282F / 28-Feb-2017CBR - 000552 / 21-Apr-2017Rtgs - 000029 / 24-Apr-2017,6252140,5679600,572540
76120,192-16-000017,Improvements to chikkathoguru main road from Hosur main road to Chikkathoguru village in Ward No 192,VINOD KUMAR B K8884572139,BR - 00282G / 28-Feb-2017CBR - 001107 / 03-May-2017Rtgs - 000043 / 05-May-2017,4471770,4058410,413360
75229,192-16-000028,Development and improvements to roads and drains in main road and cross roads of ward No 192 Begur.,KRIDL9448489352,BR - 000253 / 04-Feb-2017CBR - 001232 / 04-May-2017Rtgs - 000044 / 05-May-2017,3401860,2835195,566665
15954,R-192-15-000002,PRVD IMPTS TO C/R OF NOBEL RESIDENCY IN WARD NO 146,KRIDL8105654121,BR - 000535 / 30-Mar-2015CBR - 001055 / 02-May-2017Rtgs - 000045 / 05-May-2017,4947260,3039565,1907695
15957,R-192-15-000003,PRVD IMPTS TO RDS OF NEW MICO L/O IN WARD NO 146,KRIDL8105654121,BR - 000536 / 30-Mar-2015CBR - 001056 / 02-May-2017Rtgs - 000045 / 05-May-2017,4394395,2468815,1925580
56578,192-15-000011,Improvements of roads at Pavan Layout near Basavanapura village in ward No 192 Begur,MAHESH V T9900031052,BR - 000012 / 30-Apr-2015CBR - 001328 / 08-May-2017Rtgs - 000052 / 10-May-2017,2019980,1741550,278430
14034,192-14-000021,Drilling of borewells and errection of pump and motor north side of Begur in ward No 192 Begur,A Francis 9036718749,BR - 000233 / 29-Feb-2016CBR - 001909 / 19-May-2017Rtgs - 000064 / 20-May-2017,1531130,1337425,193705
6978,192-14-000009,Annual Maintenance of Sanitary system in ward No 192 Begur,A Francis 1234567890,BR - 000183 / 19-Dec-2015CBR - 002189 / 25-May-2017Rtgs - 000075 / 27-May-2017,1463170,1259985,203185
6144,192-15-000001,Supplying drinking water through tankers East side of Begur in ward No 192,A Francis 1234567890,BR - 000172 / 17-Nov-2015CBR - 002190 / 25-May-2017Rtgs - 000075 / 27-May-2017,1574040,1374910,199130
57566,192-15-000023,Improvements of roads near Naganeshwara Temple in ward no 192 Begur,KRIDL9342540302,BR - 000109 / 27-Aug-2015CBR - 002477 / 31-May-2017Rtgs - 000084 / 01-Jun-2017,1585250,1336910,248340
83929,192-16-000023,Drilling of Borewells and fixing of pump and motors in Subashnagar Basavapura Doddakamanahalli and various areas in Ward No 192 Begur,KRIDL9980795596,BR - 000263 / 28-Feb-2017CBR - 002711 / 06-Jun-2017Rtgs - 000088 / 07-Jun-2017,4788870,4081810,707060
84031,192-16-000026,Drilling of Borewells and fixing of pump and motors in cross roads of Begur Village in Ward No 192,KRIDL9980795596,BR - 000262 / 28-Feb-2017CBR - 002712 / 06-Jun-2017Rtgs - 000088 / 07-Jun-2017,4811940,4103740,708200
9584,192-14-000026,Annual Maintenance of borewells to North,KMVSN Raju8105818888,BR - 000224 / 16-Feb-2016CBR - 002734 / 07-Jun-2017Rtgs - 000092 / 09-Jun-2017,1811031,1570996,240035
9574,192-13-000002,DRILLING OF BOREWELL WITH MINI WATER SUPPLY SYSTEM AT RAGHAVENDRA LAY OUT IN WARD NO 192 BEGUR,Francis A 9448489352,BR - 000220 / 16-Feb-2016CBR - 002775 / 08-Jun-2017Rtgs - 000092 / 09-Jun-2017,506847,420582,86265
9573,192-12-000031,DRILLING OF BORE WELLS AND ERRECTION OF PUMP AND MOTOR TO NORTH AND SOUTH SIDE OF BEGUR WARD NO 192,N Jagadish9342540302,BR - 000222 / 16-Feb-2016CBR - 002776 / 08-Jun-2017Rtgs - 000092 / 09-Jun-2017,1302750,1112085,190665
8577,192-13-000015,CONSTRUCTION OF ANGANAWADI BUILDING AT CHIKKA THOGURU VILLAGE IN WARD NO 192 BEGUR,Vijay Kumar B R 9980046582,BR - 000201 / 28-Jan-2016CBR - 003387 / 22-Jun-2017Rtgs - 000119 / 23-Jun-2017,488620,424495,64125
9052,192-15-000005,Filling of potholes in ward No 192 Begur,Venkatakrishna9141648915,BR - 000218 / 08-Feb-2016CBR - 003393 / 22-Jun-2017Rtgs - 000119 / 23-Jun-2017,1565192,1344052,221140
52006,192-16-000013,Supplying drinking water through tankers of Begur in ward No 192 (POW 2015-16),Ravi kumar S8123401519,BR - 000141 / 12-Sep-2016CBR - 003511 / 27-Jun-2017Rtgs - 000123 / 27-Jun-2017,2612140,2280730,331410
5790,192-15-000002,Supplying drinking water through tankers West side of Begur in ward No 192,H M Munikrishna1234567890,BR - 000163 / 31-Oct-2015CBR - 003726 / 10-Jul-2017Rtgs - 000136 / 12-Jul-2017,1974000,1724000,250000
53662,192-14-000066,Improvements works to Electrical Street ligting system in Kalena Agrahara MLA Layout and Surrounding Layouts of ward no 192 Begur,M/s Technical Manager KRIDL1921400000,BR - 000122 / 16-Oct-2015CBR - 003967 / 15-Jul-2017Rtgs - 000144 / 18-Jul-2017,2586364,2200984,385380
5824,192-14-000055,Supplying of drinking water through water tankers at Doddakammanahalli village in ward No 192,KRIDL9845966999,BR - 000160 / 31-Oct-2015CBR - 004004 / 17-Jul-2017Rtgs - 000144 / 18-Jul-2017,600842,511217,89625
5826,192-14-000044,Supplying of drinking water through tankers at Subhash Nagara Layout in ward No 192,KRIDL9845131166,BR - 000161 / 31-Oct-2015CBR - 004005 / 17-Jul-2017Rtgs - 000144 / 18-Jul-2017,273482,233547,39935
5836,192-13-000088,Construction of Toilet near Govt middle school at Chikka Kammanahalli in ward no 192,KRIDL9980795596,BR - 000165 / 31-Oct-2015CBR - 004006 / 17-Jul-2017Rtgs - 000144 / 18-Jul-2017,545600,453210,92390
28232,192-14-000060,Improvements to roads and drains at Kalena Agrahara village layouts in ward No 192,KRIDL9845966999,BR - 000020 / 30-Apr-2015CBR - 004016 / 18-Jul-2017Rtgs - 000144 / 18-Jul-2017,2969196,2472604,496592
12134,192-14-000004,Emergency works in ward No 192 Begur,K Nagaraj9141648915,BR - 000235 / 01-Mar-2016CBR - 004042 / 20-Jul-2017Rtgs - 000155 / 25-Jul-2017,994180,846235,147945
5152,192-14-000008,Annual Maintenance of borewells to West side of Begur ward No 192 Begur,KMVSN Raju9739163616,BR - 000143 / 30-Sep-2015CBR - 004348 / 01-Aug-2017Rtgs - 000167 / 03-Aug-2017,972950,847930,125020
5147,192-14-000007,Annual Maintenance of borewells to East side of Begur ward No 192 Begur,KMVSN Raju9739163616,BR - 000144 / 30-Sep-2015CBR - 004349 / 01-Aug-2017Rtgs - 000167 / 03-Aug-2017,973560,847975,125585
29894,192-12-000058,"PROVIDING ENERGY SAVING EQUIPMENTS AND TIMER CONTROLS ALONG WITH CONNECTED ACCESSORIES TO STREET LIGHTS AND HIGH MASTS AT WARD NO 192, 194, 196 AND 191","M/S HIMAGIRISREE ELECTRICALS, 9845273024",BR - 000052 / 16-Jun-2015CBR - 004528 / 05-Aug-2017Rtgs - 000174 / 08-Aug-2017,186307,158712,27595
92502,192-16-000024,Drilling of Borewells and fixing of pump and motors in Chikamanhalli Kalenagrahara and various areas in Ward No 192 Begur,KRIDL9448489352,BR - 000049 / 31-May-2017CBR - 004839 / 18-Aug-2017Rtgs - 000190 / 22-Aug-2017,4860000,4142775,717225
2059,192-15-000018,Construction of remaining length of RCC Drain at A K Colony in ward No 192 Begur,S Krishna9591160491,BR - 000079 / 14-Jul-2015CBR - 004888 / 21-Aug-2017Rtgs - 000191 / 22-Aug-2017,1010469,865147,145322
7902,192-15-000023,Improvements of roads near Naganeshwara Temple in ward no 192 Begur,KRIDL9342540302,BR - 000190 / 31-Dec-2015CBR - 004912 / 21-Aug-2017Rtgs - 000191 / 22-Aug-2017,404930,333710,71220
63909,192-11-000075,Drilling of 1 No. Borewell in ST colony of Basavanapura village in ward no. 192,NAGARAJ REDDY9880290051,BR - 000226 / 30-Dec-2016CBR - 004938 / 22-Aug-2017Rtgs - 000194 / 23-Aug-2017,513000,415220,97780
63888,192-11-000070,Drilling of 1 No. Borewell in ST Colony of Begur village in ward no. 192,NAGARAJA REDDY9880290051,BR - 000225 / 30-Dec-2016CBR - 004939 / 22-Aug-2017Rtgs - 000194 / 23-Aug-2017,513200,414135,99065
63920,192-11-000094,Drilling of Borewells with water supply system at SC/ST colony at Kalena Agrahara village in ward no. 192,KMVSN RAJU9880290051,BR - 000228 / 30-Dec-2016CBR - 004940 / 22-Aug-2017Rtgs - 000194 / 23-Aug-2017,483600,385365,98235
63912,192-11-000077,Drilling of 2 No. Borewells in ST colony of Elenahalli village of ward no. 192,KMVSN RAJU9880290051,BR - 000227 / 30-Dec-2016CBR - 004941 / 22-Aug-2017Rtgs - 000194 / 23-Aug-2017,1015240,852330,162910
63882,192-11-000092,Drilling of Borewells with water supply system at SC/SCT colony at Begur village in ward no. 192,KMVSN RAJU9880290051,BR - 000229 / 30-Dec-2016CBR - 004942 / 22-Aug-2017Rtgs - 000194 / 23-Aug-2017,513960,409920,104040
63894,192-11-000069,Drilling of 2 Borewell in SC colony of Begur Village,KMVSN RAJU9880290051,BR - 000230 / 30-Dec-2016CBR - 004943 / 22-Aug-2017Rtgs - 000194 / 23-Aug-2017,964560,812240,152320
7709,192-14-000046,Improvements to roads and drains at Ellenahalli village layouts in ward No 192 ,KRIDL9880954000,BR - 000203 / 30-Jan-2016CBR - 005596 / 07-Sep-2017Rtgs - 000210 / 07-Sep-2017,2971680,2474234,497446
4119,192-13-000009,IMPROVEMENTS TO ROADS AT CHIKKA BEGUR COLONY NEAR RAMASWAMY HOUSE ROAD IN WARD NO 192 BEGUR,Rangaswamy T R 9972904657,BR - 000115 / 31-Aug-2015CBR - 005749 / 11-Sep-2017Rtgs - 000217 / 12-Sep-2017,784320,679560,104760
9572,192-12-000030,DRILLING OF BORE WELLS AND ERRECTION OF PUMP AND MOTER TO EAST AND WEST SIDE OF BEGUR WARD NO 192,N Jagadish9342540302,BR - 000221 / 16-Feb-2016CBR - 005961 / 16-Sep-2017Rtgs - 000225 / 20-Sep-2017,1152846,979896,172950
107014,192-17-000030,Providing BWSSB UGD and water supply works in ward no.192.,KRIDL9999999999,BR - 000007 / 01-Sep-2017CBR - 005966 / 16-Sep-2017Rtgs - 000227 / 21-Sep-2017,7481613,6658079,823534
14084,192-13-000086,Improvements of roads at Mico layout in ward no 192,KRIDL9739163616,BR - 000228 / 29-Feb-2016CBR - 006200 / 22-Sep-2017Rtgs - 000232 / 22-Sep-2017,1095890,916340,179550
13961,192-14-000034,Improvements to roads and drains at Subhash Nagara A Block areas of Begur village in ward No 192 ,KRIDL9900125654,BR - 000230 / 29-Feb-2016CBR - 006202 / 22-Sep-2017Rtgs - 000232 / 22-Sep-2017,4497500,3786230,711270
14029,192-13-000049,Providing Sanitary Line at Main roads of Ellenahalli village in ward no 192,M/s KRIDL9036718749,BR - 000232 / 29-Feb-2016CBR - 006203 / 22-Sep-2017Rtgs - 000232 / 22-Sep-2017,2195950,1846790,349160
7991,192-14-000001,Providing Sign boards in ward No 192 Begur,H M Munikrishna9980795596,BR - 000199 / 07-Jan-2016CBR - 006222 / 22-Sep-2017Rtgs - 000232 / 22-Sep-2017,2099000,1817591,281409
98002,192-16-000002,Annual Operation and Maintenance of street lighting system in Doddakammanahalli Basvanapura Tejaswini nagar Chikkakammanahalli and associated area of ward no-192 Begur Package B9B of Bommanahalli zone.,M/s Ramya Electricals9448522800,BR - 000020 / 15-Jul-2017CBR - 006306 / 25-Sep-2017Rtgs - 000236 / 27-Sep-2017,366374,308314,58060
14113,192-14-000042,Improvements to roads and drains and Construction of toilets at Chikka Begur and hale ooru of Begur village in ward No 192 ,KRIDL9845183166,BR - 000242 / 31-Mar-2016CBR - 006457 / 04-Oct-2017Rtgs - 000241 / 06-Oct-2017,4463899,3736065,727834
5788,192-13-000052,Improvements to C C road at A D Colony in Begur village in ward no 192,KRIDL1234567890,BR - 000164 / 31-Oct-2015CBR - 006502 / 04-Oct-2017Rtgs - 000241 / 06-Oct-2017,548320,452920,95400
98001,192-16-000001,Annual Operation and Maintenance of street lighting system in Begur Subhash Nagara vishwapriya Layout Bassapura and associated area of ward no-192 Begur Package B9A of Bommanahalli zone.,M/s Ramya Electricals9448522800,BR - 000019 / 15-Jul-2017CBR - 006582 / 09-Oct-2017Rtgs - 000246 / 12-Oct-2017,413448,348988,64460
8779,192-14-000049,Improvements to roads and drains at Basapura village layouts in ward No 192 ,KRIDL9900007121,BR - 000226 / 22-Feb-2016CBR - 006656 / 10-Oct-2017Rtgs - 000247 / 12-Oct-2017,4490200,3774020,716180
92070,192-17-000004,Filling of potholes in ward No 192 Begur POW 2016-17,"M/s Saani Earth Movers & Constructions, Prop : Vasu Sevarthi9900007121",BR - 000014 / 28-Apr-2017CBR - 006768 / 13-Oct-2017Rtgs - 000253 / 17-Oct-2017,1952000,1651950,300050
9580,192-13-000100,Errection of Pump and Motor to borewlls in West side of ward no 192,KRIDL9108647735,BR - 000219 / 16-Feb-2016CBR - 007030 / 25-Oct-2017Rtgs - 000260 / 28-Oct-2017,1408826,1174077,234749
53407,192-16-000012,Providing Street lights in ward No 192 Begur (POW 2015-16),M/s. Ramya Electrical9448522800,BR - 000208 / 09-Aug-2016CBR - 007107 / 28-Oct-2017Rtgs - 000266 / 30-Oct-2017,1123182,1053402,69780
7932,192-14-000048,Supplying of drinking water through water tankers at Basavanapura village in ward No 192,KRIDL9845966999,BR - 000198 / 07-Jan-2016CBR - 007208 / 31-Oct-2017Rtgs - 000277 / 08-Nov-2017,849430,697335,152095
24589,192-14-000040,Improvements to roads and drains at Left side Vittasandra road Lakshmi Layout of Begur village in ward No 192 ,M/s KRIDL9342122510,BR - 000017 / 31-May-2016CBR - 007763 / 10-Nov-2017Rtgs - 000282 / 14-Nov-2017,496716,404356,92360
22072,192-14-000044,Supplying of drinking water through tankers at Subhash Nagara Layout in ward No 192,KRIDL9845131166,BR - 000013 / 20-May-2016CBR - 007764 / 10-Nov-2017Rtgs - 000282 / 14-Nov-2017,435116,364270,70846
44998,192-13-000063,Asphalting to roads of Subhashnagara A block Maramma temple road in ward no 192,KRIDL9900125654,BR - 000139 / 12-Sep-2016CBR - 007772 / 10-Nov-2017Rtgs - 000282 / 14-Nov-2017,1059025,882010,177015
24745,192-14-000036,Improvements to roads and drains at Subhash Nagara A and B Block areas of Begur village in ward No 192 ,KRIDL9900125654,BR - 000016 / 20-May-2016CBR - 007790 / 12-Nov-2017Rtgs - 000282 / 14-Nov-2017,4495450,3784960,710490
79710,192-14-000033,Improvements to roads and drains at Hale Ooru areas of Begur village in ward No 192 ,KRIDL9448489352,BR - 000252 / 04-Feb-2017CBR - 007798 / 12-Nov-2017Rtgs - 000282 / 14-Nov-2017,4976400,4127830,848570
103497,192-13-000060,Providing sanitary and Improvements of roads to Kumbara Kunte roads at Begur village in ward no 192,KRIDL9036718749,BR - 000048 / 31-May-2017CBR - 007801 / 12-Nov-2017Rtgs - 000282 / 14-Nov-2017,2195000,1831825,363175
13718,192-14-000023,Annual Maintenance of ward area in ward No 192 Begur,Venkatakrishna9141648915,BR - 000003 / 25-Apr-2016CBR - 007576 / 09-Nov-2017Rtgs - 000290 / 17-Nov-2017,828267,709287,118980
41149,192-14-000054,Improvements to roads and drains at Chikkakammanahalli village layouts in ward No 192 ,KRIDL9980795596,BR - 000004 / 30-Apr-2016CBR - 007648 / 10-Nov-2017Rtgs - 000290 / 17-Nov-2017,2488570,2081325,407245
111248,192-16-000035,Improvements of roads and drains in Begur SC Colony in ward No 192,Antony Swamy G9880174899,BR - 000190 / 30-Jun-2017CBR - 007908 / 15-Nov-2017Rtgs - 000292 / 17-Nov-2017,1270920,1090250,180670
110580,192-17-000038,Improvements to cross roads of Akshaya nagar East s1de 6th and 8th main road )in ward no 192 Begur,KRIDL9900007123,BR - 000184 / 30-Jun-2017CBR - 008126 / 25-Nov-2017Rtgs - 000306 / 28-Nov-2017,4988580,4162100,826480
60548,192-14-000051,Improvements to linking road of Basapura layout to Grave yard in ward No 192 ,KRIDL9845612031,BR - 000194 / 28-Oct-2016CBR - 008487 / 13-Dec-2017Rtgs - 000331 / 18-Dec-2017,993520,828485,165035
54837,192-14-000050,Improvements to roads and drains at Maruthi layout and Sushruthi layouts of Basapura village in ward No 192 ,KRIDL9900007121,BR - 000199 / 28-Oct-2016CBR - 008488 / 13-Dec-2017Rtgs - 000331 / 18-Dec-2017,4990130,4147150,842980
109822,192-13-000072,Providing Sanitary Line at Main road of Pragathi Nagara (from Chikka thoguru main road) in ward no 192,KRIDL9448388395,BR - 000042 / 20-May-2017CBR - 008588 / 19-Dec-2017Rtgs - 000334 / 21-Dec-2017,2197000,1858900,338100
109829,192-13-000074,Providing Sanitary Line at Right side cross roads of Pragathi Nagara in ward no 192,KRIDL9448388395,BR - 000043 / 20-May-2017CBR - 008589 / 19-Dec-2017Rtgs - 000334 / 21-Dec-2017,1646000,1384590,261410
109826,192-13-000073,Providing Sanitary Line at Left side cross roads of Pragathi Nagara in ward no 192,KRIDL9448388395,BR - 000041 / 20-May-2017CBR - 008590 / 19-Dec-2017Rtgs - 000334 / 21-Dec-2017,1648000,1387870,260130
55584,192-14-000061,Supplying of drinking water through water tankers at Kalena Agrahara village in ward No 192,KRIDL9845966999,BR - 000207 / 16-Nov-2016CBR - 008592 / 19-Dec-2017Rtgs - 000334 / 21-Dec-2017,308600,247210,61390
110789,192-17-000039,Improvements to cross roads of MLA Layout in 1st 2nd 3rd and 4th cross) ward no 192 Begur ,KRIDL9900007121,BR - 000185 / 30-Jun-2017CBR - 008688 / 27-Dec-2017Rtgs - 000360 / 20-Jan-2018,4997900,4183170,814730
53687,192-14-000066,Improvements works to Electrical Street ligting system in Kalena Agrahara MLA Layout and Surrounding Layouts of ward no 192 Begur,M/s Technical Manager KRIDL1921400000,BR - 000237 / 03-Sep-2016CBR - 009055 / 19-Jan-2018Rtgs - 000362 / 20-Jan-2018,2357593,1989803,367790
85453,192-14-000038,Improvements to roads and drains at Right side layouts of Vittasandra road of Begur village in ward No 192 ,KRIDL9980795596,BR - 000274 / 28-Feb-2017CBR - 009652 / 08-Feb-2018Rtgs - 000386 / 08-Feb-2018,997300,799550,197750
85455,192-13-000094,Improvments to roads at Chandra shekar Pura in ward no 192,KRIDL9980795596,BR - 000273 / 28-Feb-2017CBR - 009653 / 08-Feb-2018Rtgs - 000386 / 08-Feb-2018,1099400,885200,214200
19333,192-14-000047,Improvements to roads and drains at Basavanapura village layouts in ward No 192 ,Technical Manager (East)9900007121,BR - 000011 / 16-May-2016CBR - 009668 / 08-Feb-2018Rtgs - 000388 / 09-Feb-2018,4495788,3781833,713955
23304,192-15-000016,Providing Water supply distribution line at Subhash Nagara in ward no 192,G Nagaraja Reddy9986007428,BR - 000018 / 31-May-2016CBR - 009682 / 08-Feb-2018Rtgs - 000388 / 09-Feb-2018,208810,181420,27390
139158,192-17-000030,Providing BWSSB UGD and water supply works in ward no.192.,KRIDL9999999999,BR - 000055 / 22-Jan-2018CBR - 009795 / 16-Feb-2018Rtgs - 000396 / 21-Feb-2018,10569490,9354110,1215380
56375,192-13-000028,EMERGENCY WORKS IN WARD IN WARD NO 192 BEGUR,Rangaswamy T R9141648915,BR - 000202 / 28-Oct-2016CBR - 010261 / 03-Mar-2018Rtgs - 000410 / 05-Mar-2018,520810,447600,73210
142776,192-17-000036,Providing and fixing of LED Street lights in Ward No 192 in Bangalore South Division ,M/s Shah Electricals9845058699,BR - 000063 / 09-Feb-2018CBR - 010317 / 07-Mar-2018Rtgs - 000417 / 08-Mar-2018,896150,854805,41345
146103,192-18-000006,Improvements of roads and drains at Subhash Nagara C Block of ward no 192 Begur,M/s KRIDL9900125654,BR - 000101 / 28-Feb-2018CBR - 010520 / 16-Mar-2018Rtgs - 000428 / 22-Mar-2018,4991500,4313300,678200
146167,192-18-000005,Improvements of roads and drains at Subhash Nagara B Block of ward no 192 Begur,M/s KRIDL9900125654,BR - 000102 / 28-Feb-2018CBR - 010521 / 16-Mar-2018Rtgs - 000428 / 22-Mar-2018,4991150,4312970,678180
137074,192-17-000062,Improvements to Devara Chikkanahalli to Begur main road via Narasimha Reddy house ward no 192,M/s Sri Srinivasa Constructions India pvt Ltd9845183166,BR - 000035 / 18-Jan-2018CBR - 010835 / 24-Mar-2018Rtgs - 000431 / 26-Mar-2018,2601350,2434100,167250
40888,192-14-000063,Providing drinking water distribution line at ward No 192,KRIDL9980795596,BR - 000038 / 30-Jun-2016CBR - 000837 / 30-Apr-2018Rtgs - 000032 / 03-May-2018,1989140,1683395,305745
84217,192-16-000004,Maintenance of Borewell in Begur ward No 192 (POW 2015-16),JAGADISH N9342540302,BR - 000292 / 31-Mar-2017CBR - 001031 / 03-May-2018Rtgs - 000038 / 05-May-2018,1468500,1288770,179730
41050,192-16-000010,Improvements to roads at Kshathriya nagara near Beretena agrahara in Begur ward no 192 (POW 2015-16),Franics kishore kumar 9611787247,BR - 000102 / 19-Aug-2016CBR - 001383 / 16-May-2018Rtgs - 000052 / 18-May-2018,977410,845080,132330
152890,192-17-000032,Improvements to roads from Bannerugatta road to Nobo Nagara in ward No 192 Begur,Sri B K Vinod Kumar9845222227,BR - 000191 / 31-Mar-2018CBR - 001373 / 15-May-2018Rtgs - 000055 / 21-May-2018,1937900,1865900,72000
44984,192-16-000034,Improvements to roads to roads at Ramanashree layout 2nd stage main road and cross roads in ward no 192,Kempananjegowda9900125654,BR - 000138 / 12-Sep-2016CBR - 002122 / 02-Jun-2018Rtgs - 000071 / 06-Jun-2018,2370770,2043935,326835
156179,192-17-000047,Developmental Crematorium works in W N 192,M/s KRIDL9845019972,BR - 000036 / 30-Apr-2018CBR - 002032 / 29-May-2018Rtgs - 000072 / 06-Jun-2018,7464925,6528255,936670
156242,192-17-000048,Construction and developments of toilets in W N 192,M/s KRIDL9845019972,BR - 000035 / 30-Apr-2018CBR - 002033 / 29-May-2018Rtgs - 000072 / 06-Jun-2018,1748900,1528950,219950
108953,192-17-000003,Annual Maintenance of Borewells in ward No 192 Begur POW 2016-17,Francis A9036718749,BR - 000183 / 30-Jun-2017CBR - 002339 / 11-Jun-2018Rtgs - 000079 / 11-Jun-2018,1084420,951940,132480
58534,192-16-000007,Maintenance of Culverts and drians in ward No 192 (POW 2015-16),franics kishore kumar9611787247,BR - 000193 / 28-Oct-2016CBR - 002838 / 22-Jun-2018Rtgs - 000099 / 23-Jun-2018,1464390,1276560,187830
57644,192-16-000008,Improvements to roads at Overhead tank road in Begur ward No 192 (POW 2015-16),JAGADISH N9342540302,BR - 000186 / 28-Oct-2016CBR - 003713 / 12-Jul-2018Rtgs - 000125 / 16-Jul-2018,1970730,1688740,281990
57639,192-16-000011,Improvements to roads at Chamundeshwari nagara in Begur ward no 192 (POW 2015-16),JAGADISH9342540302,BR - 000187 / 28-Oct-2016CBR - 003714 / 12-Jul-2018Rtgs - 000125 / 16-Jul-2018,987969,850169,137800
161123,192-18-000003,Improvements of roads and drains at Chikka Begur village of ward No 192 Begur,M/s KRIDL9972795369,BR - 000053 / 17-May-2018CBR - 003322 / 05-Jul-2018Rtgs - 000126 / 17-Jul-2018,4987000,4253050,733950
166105,192-17-000049,Providing UGD lines in W N 192,M/s KRIDL9036718749,BR - 000100 / 30-May-2018CBR - 004069 / 20-Jul-2018Rtgs - 000137 / 23-Jul-2018,4992500,4382150,610350
108683,192-16-000003,Filling of potholes in Begur ward No 192 (POW 2015-16),venkatakrishna9141648915,BR - 000063 / 31-May-2017CBR - 004248 / 24-Jul-2018Rtgs - 000142 / 26-Jul-2018,1919880,1651280,268600
108657,192-15-000007,Maintenance of ward No 192 Begur,venkata krishna9141648915,BR - 000064 / 31-May-2017CBR - 004249 / 24-Jul-2018Rtgs - 000142 / 26-Jul-2018,1565870,1352850,213020
108662,192-15-000004,Annual Maintenance of Sanitary in ward No 192 Begur,venkata krishna9141648915,BR - 000065 / 31-May-2017CBR - 004250 / 24-Jul-2018Rtgs - 000142 / 26-Jul-2018,1023450,905540,117910
146946,192-16-000001,Annual Operation and Maintenance of street lighting system in Begur Subhash Nagara vishwapriya Layout Bassapura and associated area of ward no-192 Begur Package B9A of Bommanahalli zone.,M/s Ramya Electricals9448522800,BR - 000083 / 22-Mar-2018CBR - 004429 / 26-Jul-2018Rtgs - 000146 / 27-Jul-2018,641155,547035,94120
146951,192-16-000002,Annual Operation and Maintenance of street lighting system in Doddakammanahalli Basvanapura Tejaswini nagar Chikkakammanahalli and associated area of ward no-192 Begur Package B9B of Bommanahalli zone.,M/s Ramya Electricals9448522800,BR - 000084 / 22-Mar-2018CBR - 004818 / 03-Aug-2018Rtgs - 000157 / 06-Aug-2018,723535,620755,102780
75422,192-16-000033,Improvements to roads to roads at Mico layout 2nd stage main roads and cross roads in ward no 192,N K MOHAN MURALI9845154892,BR - 000275 / 28-Feb-2017CBR - 004719 / 02-Aug-2018Rtgs - 000159 / 06-Aug-2018,4208600,3585360,623240
75395,192-16-000029,Improvements to roads and Drains at Lakshmi layout near Doddakammanahalli in ward no 192,N K MOHAN MURALI9845154892,BR - 000276 / 28-Feb-2017CBR - 004720 / 02-Aug-2018Rtgs - 000159 / 06-Aug-2018,3796000,3235060,560940
166057,192-18-000008,Improvements of roads and drains at Doddakammanahalli village of ward No 192 Begur,M/s KRIDL9141667771,BR - 000102 / 30-May-2018CBR - 004288 / 25-Jul-2018Rtgs - 000166 / 13-Aug-2018,7492800,6418440,1074360
166085,192-18-000011,Improvements of roads and drains at Basavanapura Colony (Koramara Beedi) of ward No 192 Begur,M/s KRIDL9113949787,BR - 000103 / 30-May-2018CBR - 004289 / 25-Jul-2018Rtgs - 000166 / 13-Aug-2018,4997700,4272860,724840
179823,192-18-000002,"Improvements of roads and drains at A K Colony, Begur village of ward No 192 Begur",M/s KRIDL9481185588,BR - 000180 / 26-Jul-2018CBR - 005240 / 14-Aug-2018Rtgs - 000181 / 25-Aug-2018,5524000,4725720,798280
180405,192-18-000004,Improvements of roads and drains at Basavapura village of ward No 192 Begur,M/s KRIDL9900125654,BR - 000182 / 27-Jul-2018CBR - 005241 / 14-Aug-2018Rtgs - 000181 / 25-Aug-2018,4992000,4264600,727400
124880,192-17-000020,Supplying drinking water through water tankersat Begur and various layout of Ward No 192 (Begur Subhash Nagara Chikka Begur Basapura Ellenahalli and Other Layout) (POW 2016-17 Water supply),Francis A9036718749,BR - 000010 / 29-Dec-2017CBR - 005964 / 25-Sep-2018Rtgs - 000218 / 27-Sep-2018,2620000,2337480,282520
155966,192-17-000042,Improvements to cross roads of Vinayaka nagara 3rd cross road near Doddakammanahalli in ward no 192 Begur ,KRIDL9900007121,BR - 000209 / 31-Mar-2018CBR - 006134 / 04-Oct-2018Rtgs - 000227 / 12-Oct-2018,1488600,1295870,192730
155975,192-17-000043,Improvements to cross roads of Vinayaka nagara (1st 2nd and 3rd cross) near Chikkathogure village in ward no 192 Begur ,KRIDL9900007121,BR - 000211 / 31-Mar-2018CBR - 006135 / 04-Oct-2018Rtgs - 000227 / 12-Oct-2018,1996500,1741020,255480
155967,192-17-000040,Improvements to Road from Nice road bridge to Chikkathogore village in ward no 192 Begur ,KRIDL9900007121,BR - 000210 / 31-Mar-2018CBR - 006136 / 04-Oct-2018Rtgs - 000227 / 12-Oct-2018,4992200,4358100,634100
155977,192-17-000034,Improvements to drainage system of 1st to 8th Cross roads at B K Residency in ward No 192 Begur,Sri B K Vinod Kumar9845222227,BR - 000037 / 30-Apr-2018CBR - 006191 / 04-Oct-2018Rtgs - 000227 / 12-Oct-2018,1136400,1098700,37700
155964,192-17-000033,Improvements to Akshya Nagara west roads in ward No 192 Begur,Sri B K Vinod Kumar9845222227,BR - 000207 / 31-Mar-2018CBR - 006243 / 07-Oct-2018Rtgs - 000228 / 12-Oct-2018,1742940,1681940,61000
155959,192-17-000041,Improvements to road and Drainage system at Nobo Nagara from Ganesha temple to SWD in ward no 192 Begur,KRIDL9900007121,BR - 000208 / 31-Mar-2018CBR - 006267 / 07-Oct-2018Rtgs - 000228 / 12-Oct-2018,1483000,1291450,191550
148779,192-17-000063,Comprehensive Developments of roads in Yelenahalli ward no 192,M/s Sri Srinivasa Constructions India Pvt Ltd9845183166,BR - 000005 / 19-Apr-2018CBR - 006632 / 12-Oct-2018Rtgs - 000235 / 16-Oct-2018,7602000,7060300,541700
197151,192-18-000023,Providing street lights and maintenance in ward no 192 Begur,M/s. Executive Engineer 9945510720,BR - 000044 / 29-Sep-2018CBR - 006804 / 16-Oct-2018Rtgs - 000245 / 17-Oct-2018,990651,882668,107983
109446,192-16-000031,Improvements to roads Vinayaka Nagara to Tejaswini Nagara in ward no 192,Vijay Kumar A9986096015,BR - 000266 / 28-Feb-2017CBR - 007230 / 02-Nov-2018Rtgs - 000267 / 16-Nov-2018,2935450,2502890,432560
195090,192-17-000031,Improvements to roads and drains in Vishwapriya Layout 3rd Block in ward No 192 Begur,Sri B K Vinod Kumar9845222227,BR - 000265 / 16-Oct-2018CBR - 008264 / 27-Dec-2018Rtgs - 000308 / 01-Jan-2019,5206200,4547430,658770
203059,192-18-000020,Construction of RCC Retaining wall for Begur tank spillway to protect erosion of road embankment in ward No.192 Begur,Sri. Chandrashekar B9738629378,BR - 000197 / 29-Oct-2018CBR - 008312 / 27-Dec-2018Rtgs - 000308 / 01-Jan-2019,2149800,2044310,105490
203482,192-17-000048,Construction and developments of toilets in W N 192,M/s KRIDL9845019972,BR - 000310 / 22-Nov-2018CBR - 008708 / 12-Jan-2019Rtgs - 000324 / 16-Jan-2019,4124500,3526233,598267
155890,192-17-000028,Drilling of Borewells and errection of pumpset in ward no 192,Sri H M Munikrishna9980795596,BR - 000187 / 31-Mar-2018CBR - 008644 / 07-Jan-2019Rtgs - 000336 / 01-Feb-2019,5132769,4539869,592900
146678,192-17-000003,Annual Maintenance of Borewells in ward No 192 Begur POW 2016-17,Francis A9036718749,BR - 000081 / 27-Feb-2018CBR - 009131 / 06-Feb-2019Rtgs - 000352 / 14-Feb-2019,912960,817660,95300
216811,192-17-000030,Providing BWSSB UGD and water supply works in ward no.192.,KRIDL9999999999,BR - 000051 / 24-Dec-2018CBR - 009264 / 14-Feb-2019Rtgs - 000353 / 15-Feb-2019,3480004,3074486,405518
135623,192-17-000002,Providing sanitary maintenance in ward No 192 Begur POW 2016-17,N Jagadish9342540302,BR - 000033 / 11-Jan-2018CBR - 009322 / 21-Feb-2019Rtgs - 000358 / 25-Feb-2019,1440560,1278870,161690
193883,192-16-000036,Providing Street light to ST Streets in ward No 192, M/s Ramya Electricals9448522800,BR - 000043 / 26-Sep-2018CBR - 009236 / 13-Feb-2019Rtgs - 000363 / 01-Mar-2019,470690,446684,24006
109357,192-16-000030,Improvements to roads and Drains at Nobel Residency to East India Factory road in ward no 192,Vijay Kumar A9986096015,BR - 000145 / 30-Jun-2017CBR - 009745 / 14-Mar-2019Rtgs - 000376 / 15-Mar-2019,1953000,1661210,291790
106188,192-17-000007,Improvements to roads and drains at Vishwapriya Layout 3rd Block cross roads from 5th to 10th Cross roads in ward No 192 Begur (POW 2016-17),SAANVI EARTH MOVERS & CONSTRUCTIONS9900007121,BR - 000153 / 30-Jun-2017CBR - 009767 / 14-Mar-2019Rtgs - 000376 / 15-Mar-2019,1996900,1687200,309700
106189,192-17-000011,Improvements to roads and drains at Basavanapura Ohni road in ward No 192 Begur (POW 2016-17),SAANVI EARTH MOVERS & CONSTRUCTIONS9900007121,BR - 000155 / 30-Jun-2017CBR - 009774 / 14-Mar-2019Rtgs - 000376 / 15-Mar-2019,2036000,1719800,316200
105209,192-13-000054,Shifting Un-Segregated wastes and storing new solid wastes in Karnataka compost development corporation Kudlu Village Singasandra ward no 192 Near Hosur road,"Executive Engineer, KRIDL9483289999",BR - 000015 / 13-Feb-2017CBR - 009895 / 22-Mar-2019Rtgs - 000384 / 25-Mar-2019,2459344,1045524,1413820
124888,192-17-000006,Engaging tractor and labour in ward No 192 Begur (POW 2016-17),R SHIVANNA9538854769,BR - 000044 / 31-Jan-2018CBR - 010137 / 28-Mar-2019Rtgs - 000392 / 28-Mar-2019,993300,890300,103000
239536,192-19-000200,Restoration of Road cut portion done by BWSSB -BESCOM-KPTCL in Yelechanahalli Doddakammanahalli Chikktogur surrounding area in ward no 192 in Bengaluru South Division roads under BBMP Limits Phase-1,M Ramesh9845057449,BR - 000435 / 27-Mar-2019CBR - 000010 / 03-Apr-2019Rtgs - 000001 / 04-Apr-2019,7100378,6790928,309450
111239,192-17-000001,Improvements to roads and drains at Akshayanagara East layout in ward no 192 Begur,KRIDL9448742983,BR - 000188 / 30-Jun-2017CBR - 000081 / 08-Apr-2019Rtgs - 000012 / 11-Apr-2019,9893930,8260640,1633290
111313,192-16-000005,Emergency works in Begur ward No 192 (POW 2015-16),Sri Venkatakrishna9141648915,BR - 000203 / 30-Jun-2017CBR - 000091 / 08-Apr-2019Rtgs - 000012 / 11-Apr-2019,1924200,1668150,256050
111316,192-16-000006,Engaging tractor and labour in ward No 192 (POW 2015-16),Venkatakrishna9141648915,BR - 000204 / 30-Jun-2017CBR - 000092 / 08-Apr-2019Rtgs - 000012 / 11-Apr-2019,481300,424240,57060
108938,192-13-000050,Providing Sanitary and C C road at Dandu Beddi in begur village in ward no 192,KRIDL9036718749,BR - 000181 / 30-Jun-2017CBR - 000728 / 23-Apr-2019Rtgs - 000028 / 25-Apr-2019,2193700,1836440,357260
223312,192-16-000002,Annual Operation and Maintenance of street lighting system in Doddakammanahalli Basvanapura Tejaswini nagar Chikkakammanahalli and associated area of ward no-192 Begur Package B9B of Bommanahalli zone.,M/s Ramya Electricals9448522800,BR - 000080 / 19-Jan-2019CBR - 000843 / 23-Apr-2019Rtgs - 000029 / 25-Apr-2019,91593,77816,13777
223311,192-16-000001,Annual Operation and Maintenance of street lighting system in Begur Subhash Nagara vishwapriya Layout Bassapura and associated area of ward no-192 Begur Package B9A of Bommanahalli zone.,M/s Ramya Electricals9448522800,BR - 000081 / 19-Jan-2019CBR - 000845 / 23-Apr-2019Rtgs - 000029 / 25-Apr-2019,103362,88635,14727
223603,192-16-000001,Annual Operation and Maintenance of street lighting system in Begur Subhash Nagara vishwapriya Layout Bassapura and associated area of ward no-192 Begur Package B9A of Bommanahalli zone.,M/s Ramya Electricals9448522800,BR - 000092 / 28-Jan-2019CBR - 001072 / 26-Apr-2019Rtgs - 000032 / 27-Apr-2019,1136984,972344,164640
223604,192-16-000002,Annual Operation and Maintenance of street lighting system in Doddakammanahalli Basvanapura Tejaswini nagar Chikkakammanahalli and associated area of ward no-192 Begur Package B9B of Bommanahalli zone.,M/s Ramya Electricals9448522800,BR - 000091 / 28-Jan-2019CBR - 001083 / 26-Apr-2019Rtgs - 000032 / 27-Apr-2019,1007530,857850,149680
243147,192-19-000200,Restoration of Road cut portion done by BWSSB -BESCOM-KPTCL in Yelechanahalli Doddakammanahalli Chikktogur surrounding area in ward no 192 in Bengaluru South Division roads under BBMP Limits Phase-1,M Ramesh9845057449,BR - 000013 / 27-Apr-2019CBR - 001225 / 29-Apr-2019Rtgs - 000034 / 03-May-2019,2677724,2562088,115636
207304,192-18-000007,Improvements of roads and drains at Kalena Agrahara village of ward No 192 Begur,M/s KRIDL9538858769,BR - 000322 / 30-Nov-2018CBR - 001453 / 13-May-2019Rtgs - 000048 / 16-May-2019,4990500,4300474,690026
217169,192-18-000013,Improvements of drains and concrete roads in Elenahalli village in ward No 192 Begur,M/s KRIDL9538858769,BR - 000344 / 29-Dec-2018CBR - 001454 / 13-May-2019Rtgs - 000048 / 16-May-2019,4996464,4273838,722626
119244,192-17-000016,Providing Name boards in ward No 192 of Begur (POW 2016-17),N Jagadish9342540302,BR - 000017 / 27-Nov-2017CBR - 002171 / 28-May-2019Rtgs - 000065 / 30-May-2019,1534970,1370550,164420
240031,192-18-000032,Providing UGD works in ward no 192,M/s KRIDL9538858769,BR - 000021 / 29-Apr-2019CBR - 002504 / 06-Jun-2019Rtgs - 000078 / 12-Jun-2019,8995284,7799708,1195576
121035,192-17-000027,Improvements to roads at A D Colony in ward no 192,K Vishwesha9845019214,BR - 000018 / 27-Nov-2017CBR - 002668 / 12-Jun-2019Rtgs - 000088 / 18-Jun-2019,3005990,2638830,367160
127273,192-17-000017,Improvements to Lingayaths burial ground of Begur in ward No 192 (POW 2016-17),K Vishwesha9845019214,BR - 000004 / 29-Dec-2017CBR - 002669 / 12-Jun-2019Rtgs - 000088 / 18-Jun-2019,1495250,1312660,182590
127292,192-17-000005,Emergency works and Ward Maintenance in Ward No 192 Begur POW 2016-17,Sri Vishwesha 9845019214,BR - 000006 / 29-Dec-2017CBR - 002802 / 17-Jun-2019Rtgs - 000089 / 20-Jun-2019,1716100,1527750,188350
254554,192-19-000001,"Construction of roads and drains at Mico Layout, Vishwapriya Layout, Akshayanagara, Subhash Nagaram, Basapura, Basavanapura, Chikkakammanahalli Doddakammanahalli of ward no 192 ",Sri B K Vinod Kumar9845222227,BR - 000084 / 14-Jun-2019CBR - 002954 / 21-Jun-2019Rtgs - 000091 / 21-Jun-2019,175268732,166585632,8683100
240803,192-18-000094,IMPROVEMENTS TO ROAD AND CC DRAIN AT CHIKKABEGUR VILLAGE OF WARD NO 192 BEGUR,M/s KRIDL9538858769,BR - 000022 / 29-Apr-2019CBR - 002963 / 24-Jun-2019Rtgs - 000097 / 01-Jul-2019,4998364,4285660,712704
254313,192-16-000001,Annual Operation and Maintenance of street lighting system in Begur Subhash Nagara vishwapriya Layout Bassapura and associated area of ward no-192 Begur Package B9A of Bommanahalli zone.,M/s Ramya Electricals9448522800,BR - 000016 / 17-Jun-2019CBR - 003381 / 06-Jul-2019Rtgs - 000109 / 08-Jul-2019,516811,440396,76415
250600,192-18-000009,Improvements of roads and drains at Begur koramara Palya village of ward No 192 Begur,M/s KRIDL9538858769,BR - 000078 / 31-May-2019CBR - 003343 / 04-Jul-2019Rtgs - 000112 / 12-Jul-2019,4994496,4275718,718778
264498,192-20-000003,"Restoration of road cut portion done by BWSSB for water supply pipe line in Classic layout, dream pradise layout, Subhash Nagara and Chikka Thoguru and surrounding areas of ward no 192 in Bangaluru South Division roads under BBMP limits Phase-2",Ramesh M9845057449,BR - 000112 / 22-Jul-2019CBR - 003961 / 24-Jul-2019Rtgs - 000126 / 25-Jul-2019,7422010,7109905,312105
189851,192-17-000044,Engagement of Gangman and Hiring of Troctor Tippers for cleaning and maintenance of road side drains and other civil works in ward 192,Sri H M Munikrishna9980795596,BR - 000260 / 29-Sep-2018CBR - 004049 / 26-Jul-2019Rtgs - 000128 / 26-Jul-2019,1196300,1095700,100600
243745,192-18-000074,Improvements to Drains and culverts at Chikkammanahalli in ward no 192 Begur,K N Shivashankaraiah 9611284153,BR - 000049 / 04-May-2019CBR - 004026 / 26-Jul-2019Rtgs - 000133 / 29-Jul-2019,2445610,2154072,291538
179817,192-18-000072,Providing Water supply to distributary line at Subhash ngara A B and C Block in ward no 192 Begur,Sri Kempananje Gowda9900125654,BR - 000183 / 27-Jul-2018CBR - 004096 / 26-Jul-2019Rtgs - 000136 / 31-Jul-2019,3876600,3439900,436700
266880,192-19-000001,"Construction of roads and drains at Mico Layout, Vishwapriya Layout, Akshayanagara, Subhash Nagaram, Basapura, Basavanapura, Chikkakammanahalli Doddakammanahalli of ward no 192 ",Sri B K Vinod Kumar9845222227,BR - 000121 / 03-Aug-2019CBR - 004375 / 07-Aug-2019Rtgs - 000150 / 09-Aug-2019,179386320,170015876,9370444
151286,192-13-000048,Providing Sanitary Line at cross roads of Ellenahalli village in ward no 192,KRIDL9342540302,BR - 000180 / 31-Mar-2018CBR - 004560 / 16-Aug-2019Rtgs - 000173 / 30-Aug-2019,1997000,1760285,236715
243836,192-18-000090,Improvements to roads and drains to kerekatee road in Begur village ward no 192 Begur,Basavaraju9535445694,BR - 000047 / 04-May-2019CBR - 004888 / 31-Aug-2019Rtgs - 000183 / 12-Sep-2019,1249772,1096582,153190
243785,192-18-000093,Providing name board in ward no 192 Begur,Basavaraju9535445694,BR - 000048 / 04-May-2019CBR - 004889 / 31-Aug-2019Rtgs - 000183 / 12-Sep-2019,833000,733559,99441
245269,192-19-000001,"Detail project report and project management consulting services for Construction of roads and drains at Mico Layout, Vishwapriya Layout, Akshayanagara, Subhash Nagaram, Basapura, Basavanapura, Chikkakammanahalli Doddakammanahalli of ward no 192 of Bangalore south consituency, Bommanahalli zone of BBMP Area, Bengaluru, Phase 1 Detail project report, Phase 2 Project Management consulting.",BVHCONSULTINGENGINEE9964339888,BR - 000063 / 28-May-2019CBR - 005059 / 12-Sep-2019Rtgs - 000185 / 13-Sep-2019,3600000,3240000,360000
268458,192-19-000001,"Detail project report and project management consulting services for Construction of roads and drains at Mico Layout, Vishwapriya Layout, Akshayanagara, Subhash Nagaram, Basapura, Basavanapura, Chikkakammanahalli Doddakammanahalli of ward no 192 of Bangalore south consituency, Bommanahalli zone of BBMP Area, Bengaluru, Phase 1 Detail project report, Phase 2 Project Management consulting.",BVHCONSULTINGENGINEE9964339888,BR - 000130 / 09-Aug-2019CBR - 005098 / 12-Sep-2019Rtgs - 000185 / 13-Sep-2019,4500000,4050000,450000
224528,192-18-000025,Maintenance of Park in ward no 192 Begur,M/s KRIDL9538858769,BR - 000423 / 27-Feb-2019CBR - 005050 / 12-Sep-2019Rtgs - 000191 / 18-Sep-2019,497736,425848,71888
224529,192-18-000028,Providing UGD works in ward no 192 Begur,M/s KRIDL9538858769,BR - 000422 / 27-Feb-2019CBR - 005052 / 12-Sep-2019Rtgs - 000191 / 18-Sep-2019,1499568,1291290,208278
110790,192-15-000003,Annual maintenance of Borewells of Begur in ward No 192,KMVSN Raju1234567890,BR - 000066 / 31-May-2017CBR - 005080 / 12-Sep-2019Rtgs - 000194 / 21-Sep-2019,1543400,1348000,195400
189834,192-18-000069,Drilling of borewells and errection of pump and motor in ward No 192,H M Munikrishna9980795596,BR - 000220 / 31-Aug-2018CBR - 005625 / 03-Oct-2019Rtgs - 000211 / 10-Oct-2019,4098800,3662245,436555
278409,192-18-000095,IMPROVEMENTS TO ROAD AND CC DRAIN AT A K COLONY BEGUR VILLAGE OF WARD NO 192 BEGUR,M/s KRIDL9538858769,BR - 000168 / 17-Sep-2019CBR - 005702 / 10-Oct-2019Rtgs - 000217 / 11-Oct-2019,4994812,4295006,699806
259627,192-18-000015,"Providing and Fixing LED Lights and fittings and electrical works in Chikka Beguru, Dodda Kammanahalli and Basavanapura in ward No 192",M/s Technical Manager-019945510720,BR - 000023 / 04-Jul-2019CBR - 005706 / 10-Oct-2019Rtgs - 000217 / 11-Oct-2019,2498956,2174691,324265
259938,192-18-000014,"Providing and fixing LED Lights and fittings and electrical works in Begur, Subhash Nagara and Chikka Begur in ward No 192",M/s Technical Manager-019945510720,BR - 000025 / 04-Jul-2019CBR - 005707 / 10-Oct-2019Rtgs - 000217 / 11-Oct-2019,2488825,2165855,322970
224240,192-18-000026,Supplying of drinking water in ward no 192 Begur,M/s KRIDL9538858769,BR - 000420 / 27-Feb-2019CBR - 005967 / 25-Oct-2019Rtgs - 000243 / 30-Oct-2019,1998999,1751378,247621
277729,192-17-000037,Providing drinking water works in Ward No 192 in Bangalore South Division ,KRIDL9999999999,BR - 000023 / 11-Sep-2019CBR - 005972 / 25-Oct-2019Rtgs - 000243 / 30-Oct-2019,1205742,1097372,108370
195074,192-17-000021,"Supplying drinking water through water tankersat Begur and Various layout of Ward No 192 (Doddakammanahalli, Chikka Kammanahalli, Basavanapura, Kalena Agrahara and other layout) (POW 2016-17 Water supply)",MUNIKRISHNA H M9980795596,BR - 000261 / 29-Sep-2018CBR - 006624 / 04-Dec-2019Rtgs - 000300 / 10-Dec-2019,1490100,1336290,153810
166625,192-17-000045,Comprehensive Development of roads and drains in ward no 192 Begur,Mr. MUNIKRISHNA H M9980795596,BR - 000135 / 31-May-2018CBR - 006813 / 13-Dec-2019Rtgs - 000327 / 04-Jan-2020,6223000,5560705,662295
166666,192-17-000023,Improvements to roads at Vishwapriya layout in ward no 192,Sri N K Mohan Murali9845154892,BR - 000141 / 31-May-2018CBR - 006815 / 13-Dec-2019Rtgs - 000327 / 04-Jan-2020,10275000,9006632,1268368
164731,192-17-000026,Improvements to roads at Chamundeshwari Nagara in ward no 192,Sri N K Mohan Murali9845154892,BR - 000145 / 31-May-2018CBR - 006816 / 13-Dec-2019Rtgs - 000327 / 04-Jan-2020,5110000,4473390,636610
166423,192-17-000009,Improvements to roads near Beretena Agrahara at Back side of Chowdeshwari Layout in ward No 192 Begur (POW 2016-17),K Vishwesha9845019214,BR - 000134 / 31-May-2018CBR - 006872 / 18-Dec-2019Rtgs - 000327 / 04-Jan-2020,1017000,885640,131360
304349,192-16-000002,Annual Operation and Maintenance of street lighting system in Doddakammanahalli Basvanapura Tejaswini nagar Chikkakammanahalli and associated area of ward no-192 Begur Package B9B of Bommanahalli zone.,M/s Ramya Electricals9448522800,BR - 000054 / 22-Dec-2019CBR - 007393 / 14-Jan-2020Rtgs - 000350 / 18-Jan-2020,457968,389259,68709
254314,192-16-000002,Annual Operation and Maintenance of street lighting system in Doddakammanahalli Basvanapura Tejaswini nagar Chikkakammanahalli and associated area of ward no-192 Begur Package B9B of Bommanahalli zone.,M/s Ramya Electricals9448522800,BR - 000055 / 22-Dec-2019CBR - 007425 / 14-Jan-2020Rtgs - 000350 / 18-Jan-2020,457968,388963,69005
179809,192-18-000046,Improvements of roads and drains to Lakshmi Layout Begur Village of ward no 192 Begur,Sri Kempananjegowda9900125654,BR - 000189 / 28-Jul-2018CBR - 007864 / 20-Jan-2020Rtgs - 000360 / 21-Jan-2020,2088000,1824100,263900
179907,192-18-000073,Construction of culverts and improvements of roads at MM Layout Subhash ngara in ward no 192,Kempananje Gowda9900125654,BR - 000190 / 28-Jul-2018CBR - 007865 / 20-Jan-2020Rtgs - 000360 / 21-Jan-2020,1048000,929550,118450
166679,192-12-000050,IMPROVEMENTS TO ROADS OF SHASTRI BEEDI IN BEGUR VILLAGE IN WARD NO 192 BEGUR,Venkatakrishna9141648915,BR - 000148 / 31-May-2018CBR - 008076 / 24-Jan-2020Rtgs - 000370 / 03-Feb-2020,1249600,1089820,159780
296095,192-17-000048,Construction and developments of toilets in W N 192,M/s KRIDL9845019972,BR - 000246 / 23-Dec-2019CBR - 008229 / 01-Feb-2020Rtgs - 000382 / 07-Feb-2020,4077250,3499952,577298
304347,192-16-000001,Annual Operation and Maintenance of street lighting system in Begur Subhash Nagara vishwapriya Layout Bassapura and associated area of ward no-192 Begur Package B9A of Bommanahalli zone.,M/s Ramya Electricals9448522800,BR - 000053 / 22-Dec-2019CBR - 008242 / 01-Feb-2020Rtgs - 000396 / 11-Feb-2020,516811,440391,76420
322693,192-20-000008,Raising of U Shape SWD drain and Remodelling of missing bits and chain link fencing in Ward No.192,M/s KRIDL9845936816,BR - 000169 / 26-Feb-2020CBR - 009059 / 17-Mar-2020Rtgs - 000435 / 18-Mar-2020,9797132,8786682,1010450
331069,192-20-000009,Raising of U Shape SWD drain from MICO Layout to Begur Ward No.192,M/s KRIDL9845936816,BR - 000001 / 08-Apr-2020CBR - 000194 / 21-May-2020Rtgs - 000039 / 26-May-2020,9843724,8845642,998082
189836,192-18-000077,Improvements of Roads and Drains at Pragathi Nagara in Chikka Thoguru in ward no 192 Begur,Kempananje Gowda9900125654,BR - 000217 / 31-Aug-2018CBR - 000378 / 28-May-2020Rtgs - 000053 / 01-Jun-2020,5244900,4581312,663588
189841,192-18-000033,Improvements of roads and drains to Dodda Kammanahalli Village of ward no 192 Begur ,FRANCIS A S/O ANTH9448489352,BR - 000218 / 31-Aug-2018CBR - 000380 / 28-May-2020Rtgs - 000053 / 01-Jun-2020,3561500,3110785,450715
335499,192-16-000002,Annual Operation and Maintenance of street lighting system in Doddakammanahalli Basvanapura Tejaswini nagar Chikkakammanahalli and associated area of ward no-192 Begur Package B9B of Bommanahalli zone.,M/s Ramya Electricals9448522800,BR - 000012 / 08-May-2020CBR - 000480 / 28-May-2020Rtgs - 000056 / 02-Jun-2020,2073282,1833530,239752
335482,192-16-000001,Annual Operation and Maintenance of street lighting system in Begur Subhash Nagara vishwapriya Layout Bassapura and associated area of ward no-192 Begur Package B9A of Bommanahalli zone.,M/s Ramya Electricals9448522800,BR - 000014 / 08-May-2020CBR - 000482 / 28-May-2020Rtgs - 000056 / 02-Jun-2020,2091391,1834576,256815
336405,192-16-000002,Annual Operation and Maintenance of street lighting system in Doddakammanahalli Basvanapura Tejaswini nagar Chikkakammanahalli and associated area of ward no-192 Begur Package B9B of Bommanahalli zone.,M/s Ramya Electricals9448522800,BR - 000018 / 13-May-2020CBR - 000488 / 28-May-2020Rtgs - 000056 / 02-Jun-2020,334779,293737,41042
336404,192-16-000001,Annual Operation and Maintenance of street lighting system in Begur Subhash Nagara vishwapriya Layout Bassapura and associated area of ward no-192 Begur Package B9A of Bommanahalli zone.,M/s Ramya Electricals9448522800,BR - 000019 / 13-May-2020CBR - 000489 / 29-May-2020Rtgs - 000056 / 02-Jun-2020,354722,312404,42318
189835,192-18-000056,Improvements of roads and drains to Basavanapura Village of ward No 192 Begur,H C Umesh9113949787,BR - 000219 / 31-Aug-2018CBR - 000398 / 28-May-2020Rtgs - 000060 / 03-Jun-2020,3672600,3281458,391142
313903,192-19-000001,"Construction of roads and drains at Mico Layout, Vishwapriya Layout, Akshayanagara, Subhash Nagaram, Basapura, Basavanapura, Chikkakammanahalli Doddakammanahalli of ward no 192 ",Sri B K Vinod Kumar9845222227,BR - 000278 / 27-Jan-2020CBR - 000532 / 30-May-2020Rtgs - 000066 / 06-Jun-2020,35061990,32998383,2063607
242258,192-18-000084,Re Asphalting to roads in Duoheights Layout in ward no 192 Begur,L Somashekar9448073935,BR - 000010 / 25-Apr-2019CBR - 000874 / 15-Jun-2020Rtgs - 000081 / 19-Jun-2020,4974350,2182682,2791668
193623,192-17-000008,Improvements to roads and drains at Akshya Garden in ward NO 192 Begur (POW 2016-17),Saanvi Earth Movers & Construction9900007121,BR - 000242 / 25-Sep-2018CBR - 000917 / 17-Jun-2020Rtgs - 000085 / 22-Jun-2020,1995800,1720830,274970
193698,192-18-000071,Improvements of Roads and Drains at Akshaya Nagara East Layout 4th and 2nd A Cross roads in ward no 192,M/s KRIDL9900007121,BR - 000243 / 25-Sep-2018CBR - 000918 / 17-Jun-2020Rtgs - 000085 / 22-Jun-2020,4998800,4268950,729850
193663,192-18-000070,"Providing Drainage System and Improvements of Roads and Drains at Akshayanagara East Layout Sindura Cross road 5,6,7, 1st A B C 2nd 3rd 4th and 6th Main Roads in ward no 192",M/s KRIDL9900007121,BR - 000244 / 25-Sep-2018CBR - 000919 / 17-Jun-2020Rtgs - 000085 / 22-Jun-2020,4996400,4266910,729490
322771,192-19-000118,Construction of RCC Drain and Footpath at Vishwapriya layout Main road from Ch: 00.00 to 350.00 mtr at Begur in ward no 192 Begur,M/s KRIDL9480828220,BR - 000295 / 29-Feb-2020CBR - 000018 / 03-Apr-2020Rtgs - 000090 / 23-Jun-2020,6986494,6051149,935345
267304,192-13-000079,Providing Sanitary line to cross road of Basapura village in ward no 192,KRIDL1234567890,BR - 000124 / 07-Aug-2019CBR - 001429 / 30-Jun-2020Rtgs - 000123 / 03-Jul-2020,2196456,1896768,299688
267260,192-17-000010,Improvements to roads and drains of Dodda Kammanahalli layout road (Near Help centre) in ward No 192 Begur (POW 2016-17),Nanjundeshwara Enterprises1234567891,BR - 000125 / 07-Aug-2019CBR - 001430 / 30-Jun-2020Rtgs - 000123 / 03-Jul-2020,1959770,1735984,223786
200681,192-18-000065,Maintenance of Sanitary in ward no 192 Begur,Sri N Jagadish9342540302,BR - 000266 / 17-Oct-2018CBR - 001743 / 09-Jul-2020Rtgs - 000153 / 13-Jul-2020,2087900,1834155,253745
342555,192-16-000001,Annual Operation and Maintenance of street lighting system in Begur Subhash Nagara vishwapriya Layout Bassapura and associated area of ward no-192 Begur Package B9A of Bommanahalli zone.,M/s Ramya Electricals9448522800,BR - 000031 / 07-Jun-2020CBR - 001649 / 07-Jul-2020Rtgs - 000156 / 14-Jul-2020,177361,156202,21159
342557,192-16-000002,Annual Operation and Maintenance of street lighting system in Doddakammanahalli Basvanapura Tejaswini nagar Chikkakammanahalli and associated area of ward no-192 Begur Package B9B of Bommanahalli zone.,M/s Ramya Electricals9448522800,BR - 000032 / 07-Jun-2020CBR - 001650 / 07-Jul-2020Rtgs - 000156 / 14-Jul-2020,167389,146418,20971
323350,192-18-000027,Maintenance of Sptage in ward no 192 Begur,M/s KRIDL9538858769,BR - 000300 / 05-Mar-2020CBR - 001930 / 15-Jul-2020Rtgs - 000178 / 18-Jul-2020,498900,444875,54025
200231,192-17-000055,Providing CC Camera at Garbage Block Spots in ward no 192,M/s Imperial Constrafin Pvt Ltd9342811426,BR - 000267 / 25-Oct-2018CBR - 002915 / 26-Nov-2020Rtgs - 000215 / 26-Nov-2020,898000,801090,96910
349301,192-18-000002,"Improvements of roads and drains at A K Colony, Begur village of ward No 192 Begur",M/s KRIDL9481185588,BR - 000124 / 03-Jul-2020CBR - 003145 / 02-Dec-2020Rtgs - 000222 / 05-Dec-2020,1961600,1768957,192643
203622,192-18-000062,Supplying drinking water through tankers to Chikka Kammanahalli and Basavanapura village in ward No 192 Begur,Sri S Ravi Kumar9611140040,BR - 000305 / 19-Nov-2018CBR - 001709 / 08-Jul-2020Rtgs - 000226 / 07-Dec-2020,1466200,1315970,150230
210968,192-18-000064,Maintenance of Borewells at East side of ward No 192 Begur,Sri Francis A9036718749,BR - 000336 / 19-Dec-2018CBR - 003331 / 10-Dec-2020Rtgs - 000233 / 16-Dec-2020,1997000,1798520,198480
331286,192-20-000025,Improvements of roads and drains in Ramanashree Layout of Ward no 192 Begur Annex 02 Sl No 846,M/s KRIDL9480828220,BR - 000005 / 20-Apr-2020CBR - 003516 / 22-Dec-2020Rtgs - 000239 / 24-Dec-2020,19596200,17779865,1816335
333456,192-20-000023,Improvements to roads and drains at Classic Layout and Surrounding area in ward no 192 Begur Annex 02 Sl No 844,M/s KRIDL9480828220,BR - 000034 / 07-May-2020CBR - 003611 / 23-Dec-2020Rtgs - 000239 / 24-Dec-2020,9856190,8860839,995351
333435,192-20-000017,Improvements to roads and drains at Thejaswini Nagara and Surrounding area in ward no 192 Begur Annex 02 Sl No 837,M/s KRIDL9480828220,BR - 000035 / 07-May-2020CBR - 003612 / 23-Dec-2020Rtgs - 000239 / 24-Dec-2020,19704310,17714261,1990049
333423,192-20-000019,Improvements to roads and drains at Chamundeshwari Layout and Surrounding area in ward no 192 Begur Annex 02 Sl No 839,M/s KRIDL9480828220,BR - 000036 / 07-May-2020CBR - 003613 / 23-Dec-2020Rtgs - 000239 / 24-Dec-2020,9855356,8867071,988285
335492,192-20-000018,Improvements to roads and drains at Nobal Residency and surrounding area in ward no 192 Begur Annex 02 Sl No 838,M/s KRIDL9480828220,BR - 000037 / 07-May-2020CBR - 003614 / 23-Dec-2020Rtgs - 000239 / 24-Dec-2020,14769700,13183351,1586349
383113,192-20-000001,Development of roads and drains in SC-ST areas in Ward No.192 Begur,Ms KRIDL9480828220,BR - 000257 / 21-Nov-2020CBR - 003863 / 24-Dec-2020Rtgs - 000241 / 28-Dec-2020,9019840,8142175,877665
389598,192-20-000001,Development of roads and drains in SC-ST areas in Ward No.192 Begur,Ms KRIDL9480828220,BR - 000318 / 11-Dec-2020CBR - 003865 / 24-Dec-2020Rtgs - 000241 / 28-Dec-2020,10579000,9616470,962530
396445,192-20-000046,"Providing Asphalting and Improvements to road side drains Near St Ann s School, Akshaya Garden and surrounding area in ward no 192 Begur",N K Mohan Murali9845154892,BR - 000386 / 30-Dec-2020CBR - 004468 / 22-Feb-2021Rtgs - 000281 / 25-Feb-2021,7696200,6896892,799308
396356,192-20-000041,Construction of Storm Water Drain at Vishwapriya layout and Yajaman Layoaut in ward no 192,N K Mohan Murali9845154892,BR - 000387 / 30-Dec-2020CBR - 004469 / 22-Feb-2021Rtgs - 000281 / 25-Feb-2021,3400850,3047607,353243
203498,192-17-000005,Emergency works and Ward Maintenance in Ward No 192 Begur POW 2016-17,Sri Vishwesha 9845019214,BR - 000311 / 22-Nov-2018CBR - 004727 / 06-Mar-2021Rtgs - 000292 / 09-Mar-2021,377400,343390,34010
203484,192-17-000015,Improvements to roads and drains of Lakshmi Layout in ward No 192 Begur (POW 2016-17),Sri K Vishwesha9845019214,BR - 000317 / 24-Nov-2018CBR - 004840 / 09-Mar-2021Rtgs - 000296 / 16-Mar-2021,1543000,1353860,189140
386721,192-19-000013,Storm water drains in ward no 192 Begur,Nagesha K9141667771,BR - 000263 / 26-Nov-2020CBR - 005110 / 16-Mar-2021Rtgs - 000302 / 23-Mar-2021,869460,780199,89261
334712,192-20-000024,Improvements of roads and drains in Nobo Nagara of Ward no 192 Begur Annex 02 Sl No 845,M/s KRIDL9480828220,BR - 000065 / 22-May-2020CBR - 005334 / 24-Mar-2021Rtgs - 000305 / 25-Mar-2021,19524800,17553285,1971515
363070,192-20-000001,Providing Consultancy Services for Preparation of Project Management Consultancy (PMC) for the works of Development of roads and drains in SC-ST areas in Ward No.192 Begur,"M/s VSR Civil Infra Pvt Ltd,9845230975",BR - 000342 / 19-Dec-2020CBR - 005176 / 23-Mar-2021Rtgs - 000306 / 25-Mar-2021,166000,149400,16600
346647,192-20-000021,Improvements to roads and drains at Vinayaka Layout and Surrounding area Near Doddakammanahalli in ward no 192 Begur Annex 02 Sl No 841,M/s KRIDL9480828220,BR - 000105 / 26-Jun-2020CBR - 005479 / 25-Mar-2021Rtgs - 000308 / 26-Mar-2021,9772800,8783244,989556
305007,192-18-000029,Maintenance of Roads footpath and culverts in ward no 192 Baguru,M/s KRIDL9538858769,BR - 000296 / 29-Feb-2020CBR - 005363 / 24-Mar-2021Rtgs - 000317 / 29-Mar-2021,1499080,1291407,207673
305157,192-18-000030,Desilting of storm water drain in ward no 192,M/s KRIDL9538858769,BR - 000297 / 29-Feb-2020CBR - 005508 / 26-Mar-2021Rtgs - 000317 / 29-Mar-2021,998480,863709,134771
362435,192-18-000024,Maintenance of Burial ground and office maintenance in ward no 192,M/s KRIDL9538858769,BR - 000255 / 18-Nov-2020CBR - 005817 / 28-Mar-2021Rtgs - 000317 / 29-Mar-2021,498260,440370,57890
389770,192-19-000006,Providing Street lights and Maintenance in ward no 192 Begur,M/s.Executive Engineer-01 KRIDL9945510720,BR - 000065 / 15-Dec-2020CBR - 005825 / 28-Mar-2021Rtgs - 000317 / 29-Mar-2021,998545,917564,80981
347285,192-20-000022,Improvements to roads and drains at Cental Excise Layout and Surrounding area in ward no 192 Begur Annex 02 Sl no 843,M/s KRIDL9480828220,BR - 000129 / 16-Jul-2020CBR - 005697 / 28-Mar-2021Rtgs - 000319 / 29-Mar-2021,7276260,6611879,664381
401446,192-19-000012,Roads and Footpath Maintenance in ward no 192 Begur,Venkatakrishna7259032791,BR - 000423 / 30-Jan-2021CBR - 005886 / 29-Mar-2021Rtgs - 000325 / 31-Mar-2021,1340100,1207522,132578
354490,192-20-000029,Improvements to roads and drains at Subhashnagara and Surrounding area in ward no 192 Begur Annex 02 Sl No 912,KRIDL BHUSIRI ACCOU0000000000,BR - 000171 / 14-Aug-2020CBR - 006045 / 31-Mar-2021Rtgs - 000326 / 31-Mar-2021,14451375,12980805,1470570
210291,192-18-000052,Improvements of Roads and drains to Patel layout 5th cross of ward no 192 Begur,"Sri Vasu Sevarthi, M/s Saanvi Earth Movers and Constructions9900007121",BR - 000329 / 30-Nov-2018CBR - / Rtgs - 000007 / 22-Apr-2021,3098000,2679308,418692
210293,192-18-000034,Improvements of roads and drains to Patel Layout 2nd and 3rd cross of ward no 192 Begur,"Sri Vasu Sevarthi, M/s Saanvi Earth Movers and Constructions9900007121",BR - 000330 / 30-Nov-2018CBR - / Rtgs - 000007 / 22-Apr-2021,2485000,2148599,336401
209804,192-18-000049,Improvements of Roads and drains to Raghavendra layout Village of ward no 192 Begur,Sri Kempananjegowda9900125654,BR - 000327 / 30-Nov-2018CBR - / Rtgs - 000007 / 22-Apr-2021,2084000,1823596,260404
209801,192-18-000048,Improvements of drains to Mico Layout of ward no 192 Begur,Sri Kempananjegowda9900125654,BR - 000328 / 30-Nov-2018CBR - / Rtgs - 000007 / 22-Apr-2021,2087000,1826882,260118
414413,192-20-000051,Construction of SWD near Beguru main road in Begur ward no 192,M/s Loukya Constructions8150913165,BR - 000173 / 25-Mar-2021CBR - / Rtgs - 000014 / 30-Apr-2021,778400,724200,54200
210914,192-18-000066,Maintenance of ward in ward No 192 Begur,Sri A Francis 9036718749,BR - 000337 / 19-Dec-2018CBR - / Rtgs - 000018 / 04-May-2021,3992000,3568314,423686
214162,192-18-000051,Improvements of Roads and drains to Mother Teresa layout of ward no 192 Begur,M/s Imperial Constrafin Pvt. Ltd. Sri Zabulon Athisayam (Managing Director)9342811426,BR - 000338 / 24-Dec-2018CBR - / Rtgs - 000018 / 04-May-2021,905000,792055,112945
218262,192-18-000042,Improvements of roads and drains to Pragathi Nagara (Chikka Thoguru) of ward no 192 Begur,"Sri Vasu Sevarthi, M/s Saanvi Earth Movers and Constructions9900007121",BR - 000367 / 31-Dec-2018CBR - / Rtgs - 000023 / 07-May-2021,3113444,2693923,419521
218102,192-18-000044,Asphalting of roads at Nanjundaiah layout cross roads of ward no 192 Begur,"Sri Vasu Sevarthi, M/s Saanvi Earth Movers and Constructions9900007121",BR - 000368 / 31-Dec-2018CBR - / Rtgs - 000023 / 07-May-2021,3114686,2693047,421639
218421,192-18-000040,Improvements of roads and drains to Vinayaka Nagara of ward no 192 Begur,"Sri Vasu Sevarthi, M/s Saanvi Earth Movers and Constructions9900007121",BR - 000369 / 31-Dec-2018CBR - / Rtgs - 000023 / 07-May-2021,3108734,2687752,420982
218383,192-18-000076,Construction of Culverts in ward no 192 Begur,H C Umesh9141667771,BR - 000370 / 31-Dec-2018CBR - / Rtgs - 000023 / 07-May-2021,2620878,2295366,325512
217436,192-18-000083,Improvements to drains and roads in Raghavendra layout in ward no 192 Begur,"M/s V B Constructions, Sri T N Manju9880954000",BR - 000356 / 31-Dec-2018CBR - / Rtgs - 000023 / 07-May-2021,4991544,4322119,669425
217397,192-18-000082,Improvements of drains to Mico Layout in ward no 192 Begur,Sri L Somashekar9448163484,BR - 000357 / 31-Dec-2018CBR - / Rtgs - 000023 / 07-May-2021,1973472,1735819,237653
398005,192-16-000002,Annual Operation and Maintenance of street lighting system in Doddakammanahalli Basvanapura Tejaswini nagar Chikkakammanahalli and associated area of ward no-192 Begur Package B9B of Bommanahalli zone.,M/s Ramya Electricals9448522800,BR - 000071 / 04-Jan-2021CBR - / Rtgs - 000032 / 15-May-2021,836948,735093,101855
398004,192-16-000001,Annual Operation and Maintenance of street lighting system in Begur Subhash Nagara vishwapriya Layout Bassapura and associated area of ward no-192 Begur Package B9A of Bommanahalli zone.,M/s Ramya Electricals9448522800,BR - 000073 / 04-Jan-2021CBR - / Rtgs - 000032 / 15-May-2021,886807,780406,106401
224829,192-18-000061,Supplying drinking water through tankers to Doddakammanahalli and Kalena Agrahara village in ward No 192 Begur,Sri A Francis9036718749,BR - 000398 / 31-Jan-2019CBR - / Rtgs - 000050 / 29-May-2021,1498192,1349315,148877
224229,192-18-000058,Supplying drinking water through tankers to Begur village in ward No 192 Begur,A Francis9036718749,BR - 000418 / 27-Feb-2019CBR - / Rtgs - 000050 / 29-May-2021,3997928,3580691,417237
224339,192-18-000060,Supplying drinking water through tankers to Subhash Nagara in ward No 192 Begur,Sri Shivanna R9036718749,BR - 000419 / 27-Feb-2019CBR - / Rtgs - 000050 / 29-May-2021,1036560,933567,102993
224415,192-18-000059,Supplying drinking water through tankers to Chikka Begur village in ward No 192 Begur,Sri Shivanna R9036718749,BR - 000421 / 27-Feb-2019CBR - / Rtgs - 000050 / 29-May-2021,518000,469120,48880
218400,192-18-000050,Improvements of Roads and drains to Yajaman layout and Shanthi priya layout of ward no 192 Begur,"Sri Vasu Sevarthi, M/s Saanvi Earth Movers and Constructions9900007121",BR - 000377 / 18-Jan-2019CBR - / Rtgs - 000053 / 01-Jun-2021,3094798,2676423,418375
218103,192-17-000014,Improvements to roads and drains of Nagarakatte opposite roads of ward No 192 Begur (POW 2016-17),N K Mohan Murali9845154982,BR - 000378 / 18-Jan-2019CBR - / Rtgs - 000053 / 01-Jun-2021,2481388,2159752,321636
223951,192-18-000039,Improvements of roads and drains to Basapura Village limits of ward no 192 Begur,Sri N K Mohan Murali9845154892,BR - 000384 / 31-Jan-2019CBR - / Rtgs - 000056 / 02-Jun-2021,2597314,2271235,326079
223945,192-18-000100,Improvements to Roads and drains in Akshaya Nagara in ward no 192,M/s KRIDL9900007121,BR - 000385 / 31-Jan-2019CBR - / Rtgs - 000056 / 02-Jun-2021,1987146,1710881,276265
232675,192-18-000037,Improvements of roads and drains to Akshaya Garden near Vadiraja Kalabhavana surrounding of ward no 192 Begur,"M/s Saanvi Earth Movers & Constructions, Sri Vasu Sevarthi, 9900007121",BR - 000416 / 27-Feb-2019CBR - / Rtgs - 000071 / 10-Jun-2021,2068350,1785346,283004
232763,192-18-000057,"Improvements of roads and drains to Vishwapriya layout, 3rd Block main road of ward No 192 Begur",Vasu Sevarthi (Saanvi Earth Movers and Constructions)9900007121,BR - 000417 / 27-Feb-2019CBR - / Rtgs - 000071 / 10-Jun-2021,2980900,2578072,402828
229575,192-17-000012,Improvements to roads and drains at B Block near Maramma Temple in ward No 192 Begur(POW 2016-17),Sri G Nagaraja Reddy9986007428,BR - 000424 / 27-Feb-2019CBR - / Rtgs - 000071 / 10-Jun-2021,1029010,895569,133441
232670,192-17-000024,Improvements to roads at Chikka Beguru in ward no 192,Sri P Masthi Gowda9972795369,BR - 000428 / 05-Mar-2019CBR - / Rtgs - 000076 / 14-Jun-2021,5137430,4490985,646445
421973,192-20-000041,Construction of Storm Water Drain at Vishwapriya layout and Yajaman Layoaut in ward no 192,N K Mohan Murali9845154892,BR - 000026 / 30-Apr-2021CBR - / Rtgs - 000088 / 23-Jun-2021,1854980,1706541,148439
422022,192-20-000044,Providing asphalting and Improvements to road side drains at Canara Bank and surrounding area in ward no 192,N.K.MOHAN MURALI9845154892,BR - 000024 / 30-Apr-2021CBR - / Rtgs - 000088 / 23-Jun-2021,3844860,3501197,343663
421955,192-20-000046,"Providing Asphalting and Improvements to road side drains Near St Ann s School, Akshaya Garden and surrounding area in ward no 192 Begur",N K Mohan Murali9845154892,BR - 000023 / 30-Apr-2021CBR - / Rtgs - 000088 / 23-Jun-2021,2225080,2044616,180464
422011,192-20-000047,Providing UGD for Missing bits at Begur in ward no 192 Begur,N.K.MOHAN MURALI9845154892,BR - 000025 / 30-Apr-2021CBR - / Rtgs - 000088 / 23-Jun-2021,5052520,4692682,359838
412150,192-20-000050,Improvements to roads and Footpath at Akshya Nagara in ward no 192 Begur,Srinivas Murthy N8123133506,BR - 000473 / 25-Mar-2021CBR - / Rtgs - 000088 / 23-Jun-2021,5140870,4704620,436250
421252,192-19-000124,Maintenance of Roads Footpath and culverts in ward no 192 Begur,Narasimha Murthy C9741891111,BR - 000011 / 28-Apr-2021CBR - / Rtgs - 000088 / 23-Jun-2021,1331620,1229920,101700
427649,192-20-000056,Providing UGD Line for Missing Bits in ward no 192 Begur,Dhananjaya M L9448002933,BR - 000061 / 27-May-2021CBR - / Rtgs - 000088 / 23-Jun-2021,896220,821266,74954
240167,192-18-000079,Restoration of Kaveri Water line digging portion at Vishvapriya layout in ward no 192 Begur,Chikkanarasimhaiah 9986451314,BR - 000003 / 05-Apr-2019CBR - / Rtgs - 000100 / 05-Jul-2021,5223846,4580699,643147
243890,192-17-000025,Construction of BBMP Office building and Library at Beguru Devarachikkanahalli cross road in ward no 192,K VISWESHA 9845019214,BR - 000076 / 30-May-2019CBR - / Rtgs - 000101 / 08-Jul-2021,5910538,5232747,677791
240190,192-17-000013,Improvements to roads and drains at Floor mill roads of Basapura village in ward No 192 Begur (POW 2016-17),Saanvi Earth Movers & Construction9900007121,BR - 000444 / 30-Mar-2019CBR - / Rtgs - 000106 / 15-Jul-2021,1525658,1302944,222714
240216,192-18-000043,Improvements of roads and drains to Vastu Nagara (Chikka Thoguru) of ward no 192 Begur,"Sri Vasu Sevarthi, M/s Saanvi Earth Movers and Constructions9900007121",BR - 000445 / 30-Mar-2019CBR - / Rtgs - 000106 / 15-Jul-2021,2069544,1787748,281796
241252,192-18-000091,Providing pot holes in ward no 192,Sri M D Gnanedra Murthy9986020978,BR - 000009 / 23-Apr-2019CBR - / Rtgs - 000106 / 15-Jul-2021,2963844,2654148,309696
244075,192-18-000086,Improvements to drains and roads in Chikkabegur Village in ward no 192 Begur,Chikkanarasimhaiah 9986451314,BR - 000045 / 30-Apr-2019CBR - / Rtgs - 000114 / 22-Jul-2021,4707388,4122108,585280
244035,192-18-000067,Engaging tractor and labour in ward No 192 Begur,Sri Francis A9036718749,BR - 000054 / 09-May-2019CBR - / Rtgs - 000115 / 23-Jul-2021,1995552,1796788,198764
244033,192-17-000019,Improvements to roads and drains of Sadhguru sai school roads and Kulla reddy layout of Mico Layout in ward No 192 Begur (POW 2016-17),Sri A Francis9036718749,BR - 000055 / 09-May-2019CBR - / Rtgs - 000115 / 23-Jul-2021,2057812,1792096,265716
244059,192-18-000063,Maintenance of Borewells at west side of ward No 192 Begur,Sri Francis A9036718749,BR - 000056 / 09-May-2019CBR - / Rtgs - 000115 / 23-Jul-2021,1997682,1789160,208522
243841,192-18-000041,Improvements of roads and drains to Nice Bridge to Mylasandra border of ward no 192 Begur,Vasu Sevarthi (Saanvi Earth Movers and Constructions)9845019972,BR - 000064 / 28-May-2019CBR - / Rtgs - 000118 / 27-Jul-2021,3109734,2691162,418572
421685,192-20-000001,Providing Consultancy Services for Preparation of Project Management Consultancy (PMC) for the works of (1) Development of roads and drains in SC-ST Areas in ward no 192 Begur (GO Sl No 402),M/s SSS Legacy Infra0000000000,BR - 000035 / 04-May-2021CBR - / Rtgs - 000124 / 29-Jul-2021,170000,153000,17000
377650,192-20-000027,Improvements to roads and drains at Chikka Begur and Surrounding area in ward no 192 Begur Annex 02 Sl No 910,KRIDL BHUSIRI ACCOU0000000000,BR - 000256 / 18-Nov-2020CBR - / Rtgs - 000125 / 29-Jul-2021,11272600,10134017,1138583
384863,192-20-000026,Improvements of roads and drains in Dream Paradise Layout of Ward no 192 Begur Annex 02 Sl No 847,M/s KRIDL9480828220,BR - 000261 / 24-Nov-2020CBR - / Rtgs - 000125 / 29-Jul-2021,4925500,4454435,471065
387685,192-20-000020,Improvements to roads and drains at Duo Heights Layout Main road and Surrounding area in ward no 192 Begur Annex 02 Sl No 840,M/s KRIDL9480828220,BR - 000308 / 09-Dec-2020CBR - / Rtgs - 000125 / 29-Jul-2021,9834650,8930780,903870
390203,192-20-000022,Improvements to roads and drains at Cental Excise Layout and Surrounding area in ward no 192 Begur Annex 02 Sl no 843,M/s KRIDL9480828220,BR - 000314 / 10-Dec-2020CBR - / Rtgs - 000125 / 29-Jul-2021,2523100,2286469,236631
363166,192-20-000018,Providing Consultancy Services for Preparation of Detailed Project Report (DPR) for the works of (1) Improvements to roads and drains at Duo Heights Layout Main road & Surrounding area in ward no 192 Begur (GO Sl No 840) (2) Improvements to roads and drains at Vinayaka Layout & Surrounding area Near Doddakammanahalli in ward no 192 Begur (GO Sl No 841) (3) Improvements to roads and drains at Cental Excise Layout & Surrounding area in ward no 192 Begur (GO Sl No 843) (4) Improvements to roads and drains at Nobal Residency & Surrounding area in ward no 192 Begur (GO Sl No 838) ,"M/s VSR Civil Infra Pvt Ltd,9845230975",BR - 000337 / 19-Dec-2020CBR - / Rtgs - 000125 / 29-Jul-2021,383000,344700,38300
363132,192-20-000017,"Providing Consultancy Services for Preparation of Detailed Project Report (DPR) for the works of (1) Improvements to roads and drains at Thejaswini Nagara & Surrounding area in ward no 192 Begur (GO Sl No 837) (2) Improvements to roads and drains at Chamundeshwari Layout & Surrounding area in ward no 192 Begur (GO Sl No 839) (3) Improvements to roads and drains at Chikka Thoguru, Beretena Agrahara & Surrounding area in ward no 192 Begur (GO Sl No 914)",M/s VSR Civil Infra Pvt Ltd9845230975,BR - 000338 / 19-Dec-2020CBR - / Rtgs - 000125 / 29-Jul-2021,425000,382500,42500
363088,192-20-000024,Providing Consultancy Services for Preparation of Detailed Project Report (DPR) for the works of (1) Improvements of roads and drains in Nobo Nagara of Ward no 192 Begur (GO Sl No 845) (2) Improvements of roads and drains in Ramanashree Layout of Ward no 192 Begur (GO Sl No 846) (3) Improvements of roads and drains in Dream Paradise Layout of Ward no 192 Begur (GO Sl no 847) ,"M/s VSR Civil Infra Pvt Ltd,9845230975",BR - 000339 / 19-Dec-2020CBR - / Rtgs - 000125 / 29-Jul-2021,383000,344700,38300
362973,192-20-000023,Providing Consultancy Services for Preparation of Detailed Project Report (DPR) for the works of (01) Improvements to roads and drains at Chikka Begur & Surrounding area in ward no 192 Begur (GO Sl No 910) (2) Improvements to roads and drains at Begur village & Surrounding area in ward no 192 Begur (GO Sl No 911) (3) Improvements to roads and drains at Classic Layout & Surrounding area in ward no 192 Begur (GO Sl No 844),"M/s VSR Civil Infra Pvt Ltd,9845230975",BR - 000340 / 19-Dec-2020CBR - / Rtgs - 000125 / 29-Jul-2021,425000,382500,42500
363005,192-20-000029,"Providing Consultancy Services for Preparation of Detailed Project Report (DPR) for the works of (01)Improvements to roads and drains at Subhashnagara & Surrounding area in ward no 192 Begur (GO Sl No 912) (2) Improvements to roads and drains at Chikka Kammanahalli, Basavanapura, Central Exicise Layout and Surrounding area in ward no 192 Begur (GO Sl No 913) ","M/s VSR Civil Infra Pvt Ltd,9845230975",BR - 000341 / 19-Dec-2020CBR - / Rtgs - 000125 / 29-Jul-2021,340000,306000,34000
250568,192-18-000099,Providing basic communites in Subhash Nagara and Improvements to roads in Classic Layout in ward no 192,M/s KRIDL9900007121,BR - 000077 / 31-May-2019CBR - / Rtgs - 000130 / 02-Aug-2021,3996386,3418762,577624
266851,192-19-000194,Drilling of Borewell at Begur Colony and Surrounding area in Ward No-192 Begur,H M Munikrishna9980795596,BR - 000131 / 17-Aug-2019CBR - / Rtgs - 000143 / 06-Aug-2021,2606928,2326116,280812
266853,192-19-000195,Drilling of Borewell at Chamundeshwari Layout in Ward No-192 Begur,H M Munikrishna9980795596,BR - 000132 / 17-Aug-2019CBR - / Rtgs - 000143 / 06-Aug-2021,2602972,2322593,280379
431008,192-20-000049,Construction of Public Toilet at Ward no 192 Begur,"Suresh Babu S, M/s S R Infra9902417095",BR - 000072 / 07-Jun-2021CBR - / Rtgs - 000144 / 06-Aug-2021,819670,757891,61779
438401,192-20-000039,Construction of Compound wall to Subhashnagara Burial Ground in ward no 192 Begur,N K Mohan Murali9845154892,BR - 000102 / 29-Jun-2021CBR - / Rtgs - 000156 / 13-Aug-2021,5125730,4720113,405617
437706,192-19-000122,Maintenance of sptage in ward no 192 Begur,"Mrs Prashanthi, M/s Challa Enterprises7259032791",BR - 000101 / 29-Jun-2021CBR - / Rtgs - 000156 / 13-Aug-2021,466790,429312,37478
386130,192-17-000035,Drilling of Borewells and water supply arrangements to ward no 192 Begur,Sri B K Vinod Kumar9845222227,BR - 000306 / 08-Dec-2020CBR - / Rtgs - 000168 / 19-Aug-2021,2405690,2297206,108484
437688,192-19-000123,Providing UGD works in ward no 192 Begur,Venkatakrishna7259032791,BR - 000100 / 29-Jun-2021CBR - / Rtgs - 000199 / 17-Sep-2021,1241800,1143008,98792
244133,192-18-000022,Drilling of borewells in ward no. 192,M/s KRIDL9900007121,BR - 000044 / 30-Apr-2019CBR - / Rtgs - 000213 / 28-Sep-2021,2464990,2127950,337040
405206,192-20-000028,Improvements to roads and drains at Begur village and Surrounding area in ward no 192 Begur Annex 02 Sl No 911,M/s KRIDL9480828220,BR - 000453 / 26-Feb-2021CBR - / Rtgs - 000218 / 01-Oct-2021,19144940,17616645,1528295
405220,192-20-000030,"Improvements to roads and drains at Chikka Kammanahalli, Basavanapura, Central Exicise Layout and Surrounding area in ward no 192 Begur Annex 02 Sl No 913",M/s KRIDL9480828220,BR - 000454 / 26-Feb-2021CBR - / Rtgs - 000218 / 01-Oct-2021,19354380,17819602,1534778
405230,192-20-000031,"Improvements to roads and drains at Chikka Thoguru, Beretena Agrahara and Surrounding area in ward no 192 Begur Annex 02 Sl No 914",M/s KRIDL9480828220,BR - 000455 / 26-Feb-2021CBR - / Rtgs - 000218 / 01-Oct-2021,18946500,17442295,1504205
257764,192-18-000047,Providing water supply pipe line in Begur ward no 192 Begur,Sri Francis A9036718749,BR - 000101 / 29-Jun-2019CBR - / Rtgs - 000220 / 04-Oct-2021,1991096,1781811,209285
266576,192-18-000080,Improvements to roads and drains in Chamundeshwari Layout in ward no 192 Begur,Vasu Sevarthi (Saanvi Earth Movers and Constructions)9900007121,BR - 000148 / 29-Aug-2019CBR - / Rtgs - 000239 / 11-Oct-2021,2545438,2205570,339868
266681,192-18-000038,Improvements of roads and drains to Beretena Agrahara Village of ward no 192 Begur,"M/s Saanvi Earth Movers & Constructions, Sri Vasu Sevarthi9900007121",BR - 000149 / 29-Aug-2019CBR - / Rtgs - 000239 / 11-Oct-2021,2070416,1787656,282760
271806,192-20-000002,Providing assured minimum facilities (AMF) to all polling stations of Bangalore rural Lokasabha Elections 2019 pertaining to ward no 192 Begur,Santhosh Naik9980099482,BR - 000150 / 30-Aug-2019CBR - / Rtgs - 000239 / 11-Oct-2021,277640,266844,10796
275079,192-18-000092,Asphalting to 4th cross in patel layout in ward no 192 Begur,K Manjunath9632229990,BR - 000159 / 31-Aug-2019CBR - / Rtgs - 000243 / 13-Oct-2021,2076850,1815732,261118
275064,192-18-000088,Asphalting to roads in Basapura in ward no 192 Begur,K Manjunath9632229990,BR - 000160 / 31-Aug-2019CBR - / Rtgs - 000243 / 13-Oct-2021,2091296,1831852,259444
456164,192-20-000054,Construction of Toilet in ward no 192 Begur,"V Raghuram, M/s L R Infrastructures9900000742",BR - 000174 / 01-Sep-2021CBR - / Rtgs - 000247 / 18-Oct-2021,261200,234731,26469
421713,192-20-000019,"Providing Consultancy Services for Preparation of Project Management Consultancy (PMC) for the works of (1) Improvements to roads and drains at Thejaswini Nagara & Surrounding area in ward no 192 Begur (GO Sl No 837) (2) Improvements to roads and drains at Chamundeshwari Layout & Surrounding area in ward no 192 Begur (GO Sl No 839) (3) Improvements to roads and drains at Chikka Thoguru, Beretena Agrahara & Surrounding area in ward no 192 Begur (GO Sl No 914)",M/s SSS Legacy Infra0000000000,BR - 000031 / 04-May-2021CBR - / Rtgs - 000252 / 25-Oct-2021,420000,378000,42000
421739,192-20-000020,Providing Consultancy Services for Preparation of Project Management Consultancy (PMC) for the works of (1) Improvements to roads and drains at Duo Heights Layout Main road & Surrounding area in ward no 192 Begur (GO Sl No 840) (2) Improvements to roads and drains at Vinayaka Layout & Surrounding area Near Doddakammanahalli in ward no 192 Begur (GO Sl No 841) (3) Improvements to roads and drains at Cental Excise Layout & Surrounding area in ward no 192 Begur (GO Sl No 843) (4) Improvements to roads and drains at Nobal Residency & Surrounding area in ward no 192 Begur (GO Sl No 838) ,M/s SSS Legacy Infra0000000000,BR - 000032 / 04-May-2021CBR - / Rtgs - 000252 / 25-Oct-2021,380000,342000,38000
421733,192-20-000026,Providing Consultancy Services for Preparation of Project Management Consultancy (PMC) for the works of (1) Improvements of roads and drains in Nobo Nagara of Ward no 192 Begur (GO Sl No 845) (2) Improvements of roads and drains in Ramanashree Layout of Ward no 192 Begur (GO Sl No 846) (3) Improvements of roads and drains in Dream Paradise Layout of Ward no 192 Begur (GO Sl no 847) ,M/s SSS Legacy Infra0000000000,BR - 000033 / 04-May-2021CBR - / Rtgs - 000252 / 25-Oct-2021,380000,342000,38000
421741,192-20-000030,"Providing Consultancy Services for Preparation of Project Management Consultancy (PMC) for the works of (01)Improvements to roads and drains at Subhashnagara & Surrounding area in ward no 192 Begur (GO Sl No 912) (2) Improvements to roads and drains at Chikka Kammanahalli, Basavanapura, Central Exicise Layout and Surrounding area in ward no 192 Begur (GO Sl No 913) ",M/s SSS Legacy Infra0000000000,BR - 000034 / 04-May-2021CBR - / Rtgs - 000252 / 25-Oct-2021,340000,306000,34000
385435,192-18-000075,Improvements of Drains and Roads at Beretena Agrahara in ward no 192 Begur,Chikkanarasimhaiah 9986451314,BR - 000269 / 27-Nov-2020CBR - / Rtgs - 000260 / 11-Nov-2021,1789000,1598412,190588
329041,192-18-000075,Improvements of Drains and Roads at Beretena Agrahara in ward no 192 Begur,Chikkanarasimhaiah 9986451314,BR - 000001 / 09-Apr-2020CBR - / Rtgs - 000260 / 11-Nov-2021,3131000,2809610,321390
349612,192-19-000192,Drilling of Borewell at Subhash Nagara in Ward No-192 Begur,Chikkanarasimhaiah 9986451314,BR - 000153 / 30-Jul-2020CBR - / Rtgs - 000260 / 11-Nov-2021,2467380,2241838,225542
457430,192-20-000045,Providing asphalting and Improvements to road side drains at Yajaman layout in ward no 192,N K Mohan Murali9845154892,BR - 000178 / 04-Sep-2021CBR - / Rtgs - 000263 / 15-Nov-2021,9927000,9037562,889438
462926,192-20-000055,Desilting of Drain and Repairing and fixing of Footpath Stone in ward no 192 Begur,"Babu Reddy, M/s Bhumika Enterprises9845019972",BR - 000191 / 28-Sep-2021CBR - / Rtgs - 000263 / 15-Nov-2021,1690900,1562586,128314
404388,192-19-000117,Improvements of Roads and Drains to Begur AK Colony of ward no 192 Begur,Umesha H C9141667771,BR - 000427 / 01-Feb-2021CBR - / Rtgs - 000268 / 16-Nov-2021,2567770,2297596,270174
472008,192-20-000043,"Drilling of Borewells at Chikka Thoguru, Mico Layout, Subhashnagara and surrounding area in ward no 192 Begur",N K Mohan Murali9845154892,BR - 000206 / 29-Oct-2021CBR - / Rtgs - 000287 / 08-Dec-2021,5202000,4834386,367614
471978,192-20-000042,"Drilling of Borewells at Begur, Basavanapura Doddakammanahalli and surrounding area in ward no 192 Begur",N K Mohan Murali9845154892,BR - 000205 / 29-Oct-2021CBR - / Rtgs - 000287 / 08-Dec-2021,5090300,4730787,359513
261991,192-18-000036,Improvements of roads and drains to Chikka kammanahalli Burrial ground of ward no 192 Begur,SUKI CONSTRUCTIONS9739303888,BR - 000128 / 07-Aug-2019CBR - / Rtgs - 000326 / 04-Feb-2022,983608,855224,128384
266857,192-17-000045,Comprehensive Development of roads and drains in ward no 192 Begur,Mr. MUNIKRISHNA H M9980795596,BR - 000133 / 17-Aug-2019CBR - / Rtgs - 000326 / 04-Feb-2022,3279914,2875302,404612
359975,192-19-000015,Construction of Office Building at ward no 192 Begur,KRIDL BHUSIRI ACCOU0000000000,BR - 000174 / 21-Aug-2020CBR - / Rtgs - 000341 / 16-Feb-2022,16180964,1149311,15031653
421608,192-20-000027,Improvements to roads and drains at Chikka Begur and Surrounding area in ward no 192 Begur Annex 02 Sl No 910,KRIDL BHUSIRI ACCOU0000000000,BR - 000013 / 28-Apr-2021CBR - / Rtgs - 000352 / 16-Feb-2022,8329556,7643068,686488
401580,192-19-000001,"Detail project report and project management consulting services for Construction of roads and drains at Mico Layout, Vishwapriya Layout, Akshayanagara, Subhash Nagaram, Basapura, Basavanapura, Chikkakammanahalli Doddakammanahalli of ward no 192 of Bangalore south consituency, Bommanahalli zone of BBMP Area, Bengaluru, Phase 1 Detail project report, Phase 2 Project Management consulting.",BVHCONSULTINGENGINEE9964339888,BR - 000050 / 19-May-2021CBR - / Rtgs - 000377 / 24-Feb-2022,900000,810000,90000
351899,192-18-000001,Construction of Samudaya Bhavana Building at A D Colony of ward no 192 Begur,KRIDL BHUSIRI ACCOU0000000000,BR - 000175 / 21-Aug-2020CBR - / Rtgs - 000393 / 04-Mar-2022,4091174,3627924,463250
487123,192-20-000053,Supplying of Drinking Water Through Tanker at Shastri Beedhi hosa beedi and water scarcity area in ward no 192 Begur,G S K ENTERPRISES8088393999,BR - 000239 / 23-Dec-2021CBR - / Rtgs - 000415 / 17-Mar-2022,888480,841755,46725
486729,192-19-000007,Maintenance of Cremetorium burrial grounds and office maintenance in ward no 192 Begur,EKADANTA EARTH MOVER9900000742,BR - 000238 / 22-Dec-2021CBR - / Rtgs - 000415 / 17-Mar-2022,466700,442046,24654
