id,wo num, wodetails,contractor,brnumber,amount,nett,deduction
6097,194-14-000019,DRILLING OF BOREWELLS AND ERRECTION SUBMERSIBLE PUMP IN WARD NO 194 AT PILLAGANAHALLI 1 WEAVERS COLONY 2 GOTTIGERE 2 TOTAL 5 NOs,K N Shivashankaraiah1234567890,BR - 000548 / 31-Mar-2015CBR - 002352 / 12-Jun-2016Rtgs - 000058 / 17-Jun-2016,1146167,998951,147216
10083,194-14-000051,"Providindg missing links of UGD pipe line, BS slab drain and cc roads at Gottigere in ward no 194",KRIDL9845019214,BR - 000164 / 31-Jul-2014CBR - 002677 / 17-Jun-2016Rtgs - 000066 / 23-Jun-2016,5418536,4566084,852452
10084,194-14-000049,Providindg UGD pipe line at Gottigere in ward no 194,KRIDL9845019214,BR - 000165 / 31-Jul-2014CBR - 002679 / 17-Jun-2016Rtgs - 000066 / 23-Jun-2016,5384401,4577707,806694
5246,194-15-000016,Supplying Drinking water through tankers at Weavers colony and pillaganahalli in ward no 194,A Francis9448489352,BR - 000148 / 30-Sep-2015CBR - 003307 / 25-Jun-2016Rtgs - 000070 / 02-Jul-2016,3139683,2742400,397283
5249,194-15-000015,Supplying Drinking water through tankers at Gottigere in ward no 194,S Ravikumar9611140040,BR - 000147 / 30-Sep-2015CBR - 003308 / 25-Jun-2016Rtgs - 000070 / 02-Jul-2016,1037854,911321,126533
6098,194-14-000019,DRILLING OF BOREWELLS AND ERRECTION SUBMERSIBLE PUMP IN WARD NO 194 AT PILLAGANAHALLI 1 WEAVERS COLONY 2 GOTTIGERE 2 TOTAL 5 NOs,K N Shivashankaraiah1234567890,BR - 000169 / 11-Nov-2015CBR - 003372 / 28-Jun-2016Rtgs - 000070 / 02-Jul-2016,1365538,1182360,183178
13531,R-194-16-000001,CONST ADDITIONAL CLASS ROOMS FOR HIGHER PRIMERI SCHOOL AT PILLAGANAHALLI,KRIDL9880070527,BR - 000395 / 30-Nov-2013CBR - 003046 / 22-Jun-2016Rtgs - 000071 / 02-Jul-2016,376033,307128,68905
11368,194-14-000032,Providing UGD line to 5th 6th 7th and 8th main roads at Weavers colony in ward no 194,KRIDL9845966999,BR - 000272 / 30-Aug-2014CBR - 003674 / 14-Jul-2016Rtgs - 000082 / 20-Jul-2016,2935614,2459698,475916
11365,194-14-000033,Providing CC Roads to Gottigere village in Ward no 194,KRIDL9845966999,BR - 000274 / 30-Aug-2014CBR - 003675 / 14-Jul-2016Rtgs - 000082 / 20-Jul-2016,2962301,2478474,483827
10839,194-14-000034,Providing CC roads and BS slabs drains at Krishnappa layout in ward no. 194,KRIDL9845966999,BR - 000275 / 30-Aug-2014CBR - 003676 / 14-Jul-2016Rtgs - 000082 / 20-Jul-2016,1957926,1622986,334940
11369,194-14-000050,Construction of culverts at missing reaches in ward no 194,KRIDL9845966999,BR - 000276 / 30-Aug-2014CBR - 003677 / 14-Jul-2016Rtgs - 000082 / 20-Jul-2016,326991,272106,54885
10838,194-14-000035,Providing Asphalting and Improvements to drains at Pillaganahalli in ward no 194,KRIDL9845966999,BR - 000273 / 30-Aug-2014CBR - 003710 / 14-Jul-2016Rtgs - 000082 / 20-Jul-2016,1957620,1618290,339330
36236,194-16-000018,Development and improvements to roads and drains in main road and cross roads of ward No 194 Gottigere.,KRIDL9986096015,BR - 000059 / 20-Jul-2016CBR - 004606 / 18-Aug-2016Rtgs - 000106 / 23-Aug-2016,9906614,8350242,1556372
13592,194-11-000041,Improvements to roads and drains at Shivanna layout in ward no 194 at Gottigere,KRIDL9845096084,BR - 000168 / 31-Jul-2014CBR - 004569 / 12-Aug-2016Rtgs - 000107 / 24-Aug-2016,2159939,1804872,355067
40830,194-16-000017,Developmental works for providing Drinking water facility in Gottigere Ward No 194,KRIDL9986096015,BR - 000094 / 30-Jul-2016CBR - 005520 / 29-Sep-2016Rtgs - 000125 / 01-Oct-2016,9542183,8143978,1398205
15666,194-13-000018,"Providing,Metalling and Aspalting to the roads and other improvement works at Kembathalli road pillaganahalli in ward no 194",Mukundareddy G 9845067855,BR - 000334 / 10-Nov-2014CBR - 006119 / 20-Dec-2016Rtgs - 000157 / 23-Dec-2016,1866150,1598759,267391
9325,194-14-000015,Providing pot hole filling in ward no 194,L R Madhuchandran9611311774,BR - 000524 / 28-Feb-2015CBR - 005664 / 20-Oct-2016Rtgs - 000160 / 27-Dec-2016,1047110,905586,141524
5058,194-14-000039,Improvement to main and Cross roads of Surabhi layout in ward no 194,KRIDL9900007121,BR - 000392 / 29-Nov-2014CBR - 006274 / 26-Dec-2016Rtgs - 000161 / 28-Dec-2016,4947679,4153242,794437
5063,194-14-000040,Providing Asphalting to 11th 12th and 13th main roads of Weavers Colony in ward no 194,KRIDL9900007121,BR - 000490 / 31-Jan-2015CBR - 007391 / 20-Feb-2017Rtgs - 000195 / 22-Feb-2017,4838813,4053312,785501
76016,194-16-000014,Improvements to road from Royal county to Kembathalli main road in Ward No 194,KBR INFRATECG LTD PROP K.BABU RAJU9845154892,BR - 000277 / 28-Feb-2017CBR - 000260 / 13-Apr-2017Rtgs - 000012 / 17-Apr-2017,8813700,8057300,756400
78379,194-17-000037,Providing drinking water works in Ward No 194 in Bangalore South Division,KRIDL8497856286,BR - 000097 / 27-Mar-2017CBR - 000531 / 19-Apr-2017Rtgs - 000022 / 21-Apr-2017,1299899,1139312,160587
1736,194-15-000001,Improvements of Roads and Drains at Khan layout and Surrounding areas in ward no 194,G Gopal 9900218893,BR - 000067 / 30-Jun-2015CBR - 001618 / 16-May-2017Rtgs - 000056 / 18-May-2017,2013440,1727120,286320
6086,194-15-000012,Maintenance of pot holes filling in ward 194,L R Madhuchandran1234567890,BR - 000170 / 17-Nov-2015CBR - 002195 / 25-May-2017Rtgs - 000075 / 27-May-2017,994451,859119,135332
3143,194-14-000021,MAINTENANCE OF BOREWELLS IN WARD NO 194 EXTENSION OF PIPILINE,S Narayana Reddy9901974840,BR - 000108 / 27-Aug-2015CBR - 002474 / 31-May-2017Rtgs - 000084 / 01-Jun-2017,998811,877442,121369
4872,194-15-000002,Improvements of Roads and Drains at Jayarama layout and Surrounding areas in ward no 194,K Uday Kumar9845183166,BR - 000140 / 30-Sep-2015CBR - 003022 / 14-Jun-2017Rtgs - 000100 / 14-Jun-2017,1995426,1703746,291680
4873,194-15-000005,Improvements of Roads and Drains at Shamanna layout and Surrounding areas in ward no 194,Uday Kumar K 9845183166,BR - 000141 / 30-Sep-2015CBR - 003023 / 14-Jun-2017Rtgs - 000100 / 14-Jun-2017,1986700,1701430,285270
4871,194-15-000006,Improvements of Roads and Drains at Venkateshwara layout and Surrounding areas in ward no 194,K Uday Kumar9845183166,BR - 000142 / 30-Sep-2015CBR - 003026 / 14-Jun-2017Rtgs - 000100 / 14-Jun-2017,1989400,1703770,285630
2668,194-14-000002,Providing Asphalting to 2nd phase weavers colony in ward no 194,Mukundareddy G 9845067855,BR - 000095 / 30-Jul-2015CBR - 003354 / 21-Jun-2017Rtgs - 000117 / 23-Jun-2017,1973580,1700800,272780
9765,194-15-000014,Maintenance of ward in ward no 194,Venkata Krishna9141648915,BR - 000225 / 22-Feb-2016CBR - 003394 / 22-Jun-2017Rtgs - 000119 / 23-Jun-2017,1049022,921542,127480
2618,194-14-000003,Providing Asphalting to 3rd phase weavers colony in ward no 194,Mukundareddy G 9845067855,BR - 000096 / 30-Jul-2015CBR - 003532 / 27-Jun-2017Rtgs - 000130 / 30-Jun-2017,1964230,1690750,273480
5496,194-15-000004,Improvements of Roads and Drains at Bhora layout 2nd Phase and Surrounding areas in ward no 194,K Uday Kumar9845183166,BR - 000149 / 01-Oct-2015CBR - 003676 / 10-Jul-2017Rtgs - 000136 / 12-Jul-2017,1991250,1706830,284420
44471,194-16-000002,Maintenance of ward in ward 194,Francis A9036718749,BR - 000162 / 12-Sep-2016CBR - 004646 / 08-Aug-2017Rtgs - 000177 / 10-Aug-2017,825525,729295,96230
97658,194-16-000001,Annual Operation and Maintenance of street lighting system in ward no-194 Package B11 of Bommanahalli zone.,M/s Sree Sreekanteswara Electricals9632977771,BR - 000006 / 14-Jul-2017CBR - 006334 / 25-Sep-2017Rtgs - 000236 / 27-Sep-2017,557120,472770,84350
104503,194-17-000006,Providing Street Lights in Gottigere AK Colony Pillaganahalli Mahaganapathi Layout and Tippu circle Ashraya colony and Bhovi Colony in Ward NO 194,M/s.Himagiri Shree Electricals7892710027,BR - 000030 / 18-Aug-2017CBR - 006220 / 22-Sep-2017Rtgs - 000238 / 27-Sep-2017,1530336,1432386,97950
113421,194-17-000048,Providing and fixing of LED Street lights in Ward No 194 in Bangalore South Division,M/s Sree Sreekanteswara Electricals9632977771,BR - 000036 / 25-Sep-2017CBR - 006709 / 10-Oct-2017Rtgs - 000244 / 11-Oct-2017,948042,918652,29390
15998,194-16-000010,Improvements to roads and drains at South Avenue and Surrounding areas in ward no 194,G Gopal 9900218893,BR - 000253 / 31-Mar-2016CBR - 006692 / 10-Oct-2017Rtgs - 000247 / 12-Oct-2017,1555730,1336940,218790
15382,194-16-000008,ImpImprovements to roads and drains at Surabhi layout and Surrounding areas in ward no 194,Gopal G 9900218893,BR - 000254 / 31-Mar-2016CBR - 006693 / 10-Oct-2017Rtgs - 000247 / 12-Oct-2017,993927,865007,128920
91702,194-17-000019,Pothole filling to Main and Cross Roads in ward no 194,"M/s Saani Earth Movers & Constructions, Prop : Vasu Sevarthi9900007121",BR - 000013 / 28-Apr-2017CBR - 006767 / 13-Oct-2017Rtgs - 000253 / 17-Oct-2017,1946000,1646750,299250
15402,194-16-000005,"Emergency works of Damaged culverts and drains UGD lines, water supply pipe line in ward no 194",Umesh H C 9141667771,BR - 000256 / 31-Mar-2016CBR - 006956 / 24-Oct-2017Rtgs - 000260 / 28-Oct-2017,1461010,1268467,192543
106996,194-17-000059,Improvements to roads and drains at Chaitanya layout in ward no 194,KRIDL9845154892,BR - 000070 / 31-May-2017CBR - 008123 / 25-Nov-2017Rtgs - 000306 / 28-Nov-2017,2936600,2451340,485260
6354,194-11-000075,IMPROVEMENTS TO FOOTPATH AND PARK IN WEAVERS COLONY IN FRONT OF MARAMMA TEMPLE IN WARD NO. 194,KRIDL1234567890,BR - 000173 / 20-Nov-2015CBR - 008381 / 06-Dec-2017Rtgs - 000324 / 11-Dec-2017,1370650,1115800,254850
56568,194-16-000015,IMPROVEMENTS TO PARKS AT ROYAL LAKE FRONT IN WARD NO 194 GOTTIGERE,KRIDL9999999999,BR - 000014 / 29-Jul-2016CBR - 008420 / 11-Dec-2017Rtgs - 000329 / 16-Dec-2017,4996393,4379156,617237
56547,194-16-000016,IMPROVEMENTS TO PARKS AT ROYAL COUNTY IN WARD NO 194 GOTTIGERE,KRIDL9999999999,BR - 000015 / 29-Jul-2016CBR - 008421 / 11-Dec-2017Rtgs - 000329 / 16-Dec-2017,2498572,2192746,305826
110761,194-17-000061,Improvements to roads and drains at Royal Lake Front Residency Phase 1 at Kothnur in ward no 194,KRIDL9900007121,BR - 000124 / 30-Jun-2017CBR - 008686 / 27-Dec-2017Rtgs - 000360 / 20-Jan-2018,2447860,2061890,385970
110758,194-17-000058,Improvements to roads and drains at Surabhi nagara West in ward no 194,KRIDL9900007121,BR - 000125 / 30-Jun-2017CBR - 008687 / 27-Dec-2017Rtgs - 000360 / 20-Jan-2018,3905900,3289590,616310
110925,194-17-000055,Improvements to roads and drains at Weavers Colony Ganesha Temple to Maramma Temple in ward no 194,KRIDL9845154892,BR - 000122 / 30-Jun-2017CBR - 008691 / 27-Dec-2017Rtgs - 000360 / 20-Jan-2018,3954000,3309550,644450
132622,194-17-000031,Comprehensive development of roads in Gottigere ward no 194,Sri Srinivasa Construction india pvt ltd9845183166,BR - 000007 / 29-Dec-2017CBR - 009007 / 12-Jan-2018Rtgs - 000364 / 20-Jan-2018,18601120,17515110,1086010
80428,194-17-000005,Providing UGD lines at Tippu Circle in Ward No 194,KRIDL9880940728,BR - 000001 / 06-Apr-2017CBR - 009206 / 30-Jan-2018Rtgs - 000373 / 01-Feb-2018,2433800,2036720,397080
108931,194-16-000028,Improvements of Roads and drains at Ambedkar Colony Pillaganahalli in ward no 194,Giriraju S R9880940728,BR - 000108 / 30-Jun-2017CBR - 009214 / 30-Jan-2018Rtgs - 000373 / 01-Feb-2018,297540,257755,39785
102934,194-17-000004,Drilling of New borewells Errection of pumpset Providing water supply pipe line at Gottigere A K Colony pillaganahalli Mahaganapathi layout and Bhovi Colony Kothnur in ward no 194,KRIDL9880940728,BR - 000072 / 31-May-2017CBR - 009216 / 30-Jan-2018Rtgs - 000373 / 01-Feb-2018,3512000,2976400,535600
129828,194-17-000056,Improvements to roads and drains at Weavers Colony Ganesha Temple and Cross Roads in ward no 194,kridl9845154892,BR - 000014 / 30-Dec-2017CBR - 009432 / 02-Feb-2018Rtgs - 000380 / 05-Feb-2018,3951700,3449380,502320
28016,194-16-000009,Providing balance portion of UGD lines at Ashraya Colony and Gundappa layout in ward no 194,Kiran.S9535010009,BR - 000022 / 31-May-2016CBR - 009684 / 08-Feb-2018Rtgs - 000388 / 09-Feb-2018,994530,863010,131520
130527,194-17-000007,Improvements to Drains and Culverts at Jambusavarai Dinne Samudaya Bhavana Road in ward no 194,KRIDL9986096015,BR - 000024 / 02-Jan-2018CBR - 009963 / 02-Mar-2018Rtgs - 000407 / 03-Mar-2018,3927670,3348510,579160
140439,194-18-000020,Improvements to Road and Drains at Krishnappa layout Pillaganahalli in ward no 194 Gottigere,M/s KRIDL9845183166,BR - 000060 / 06-Feb-2018CBR - 009967 / 02-Mar-2018Rtgs - 000407 / 03-Mar-2018,4965000,4214100,750900
32066,194-16-000007,Improvements to roads and drains at Nayak layout and Surrounding areas in ward no 194,Gopal G 9900218893,BR - 000041 / 30-Jun-2016CBR - 010115 / 02-Mar-2018Rtgs - 000418 / 12-Mar-2018,2068610,1771480,297130
130512,194-17-000008,Improvements to Roads at Jambusavarai Dinne Samudaya Bhavana Road in ward no 194,KRIDL9986096015,BR - 000023 / 02-Jan-2018CBR - 010343 / 08-Mar-2018Rtgs - 000421 / 15-Mar-2018,3435940,2929020,506920
62390,194-16-000003,Maintenance of Filling Pothole in ward no 194,VENKATAKRISHNA9141648915,BR - 000211 / 25-Nov-2016CBR - 010327 / 07-Mar-2018Rtgs - 000422 / 15-Mar-2018,1914000,1653580,260420
144190,194-17-000067,Providing Modren Dust Bin in Bangalore City in ward no 194,Sri Bharath S9620350580,BR - 000072 / 19-Feb-2018CBR - 010553 / 19-Mar-2018Rtgs - 000427 / 21-Mar-2018,129600,120240,9360
129825,194-17-000064,Improvements to roads and drains at Cross roads Deepak layout in ward no 194,KRIDL9845154892,BR - 000015 / 30-Dec-2017CBR - 010589 / 21-Mar-2018Rtgs - 000430 / 26-Mar-2018,2931400,2560310,371090
129820,194-17-000062,Improvements to roads and drains at 5th cross of Bhora layout in ward no 194,KRIDL9845154892,BR - 000016 / 30-Dec-2017CBR - 010591 / 21-Mar-2018Rtgs - 000430 / 26-Mar-2018,2469400,2154300,315100
146688,194-17-000040,Improvements of Roads and drains at Jambusavarai Dinne in ward no 194,Sri B K Vinod Kumar9845222227,BR - 000086 / 27-Feb-2018CBR - 000056 / 01-Apr-2018Rtgs - 000001 / 04-Apr-2018,2015000,1928710,86290
146690,194-17-000041,Improvements of roads and drains at Jambunagara in ward no 194,Sri B K Vinod Kumar9845222227,BR - 000088 / 27-Feb-2018CBR - 000058 / 01-Apr-2018Rtgs - 000001 / 04-Apr-2018,1522300,1458430,63870
146687,194-17-000039,Improvements of Roads and drains at Surabhi layout East and West Side in ward no 194,Sri B K Vinod Kumar9845222227,BR - 000085 / 27-Feb-2018CBR - 000130 / 02-Apr-2018Rtgs - 000001 / 04-Apr-2018,2017000,1917180,99820
34029,194-16-000023,Improvements of roads and drainages at Surabhi nagara and Jambusavari Dinne at Gottigere ward no 194,Umesh H C9141667771,BR - 000055 / 30-Jun-2016CBR - 011021 / 28-Mar-2018Rtgs - 000009 / 10-Apr-2018,3193450,2753850,439600
34033,194-16-000024,Providing drainages in Gottigere and surrounding area of Ward No 194,Umesh H C9141667771,BR - 000056 / 30-Jun-2016CBR - 011022 / 28-Mar-2018Rtgs - 000009 / 10-Apr-2018,2301298,1984991,316307
57503,194-16-000002,Maintenance of ward in ward 194,Francis A9036718749,BR - 000218 / 05-Dec-2016CBR - 000399 / 07-Apr-2018Rtgs - 000010 / 10-Apr-2018,680700,601380,79320
108932,194-16-000027,Improvements of Roads and drains at Ambedkar Colony Pillaganahalli (Bilvardahalli Main Road) in ward no 194,S R GIRIRAJU9880940728,BR - 000109 / 30-Jun-2017CBR - 000600 / 17-Apr-2018Rtgs - 000021 / 23-Apr-2018,1129270,968710,160560
66893,194-16-000011,Providing Drinking water supply through Tankers in ward no 194,Munikrishna H M9980795596,BR - 000232 / 30-Dec-2016CBR - 000696 / 25-Apr-2018Rtgs - 000028 / 26-Apr-2018,2623390,2290680,332710
63947,194-16-000004,Maintenance of Borewells in ward no 194,Thimme Gowda G9448644063,BR - 000221 / 28-Dec-2016CBR - 001024 / 03-May-2018Rtgs - 000038 / 05-May-2018,2093090,1828230,264860
137400,194-17-000060,Improvements to roads and drains at Ambedkar Colony in Pillaganahalli Village in ward no 194,KRIDL9880940728,BR - 000148 / 15-Mar-2018CBR - 001096 / 04-May-2018Rtgs - 000041 / 07-May-2018,2972700,2590280,382420
71010,194-16-000002,Maintenance of ward in ward 194,Francis A9036718749,BR - 000260 / 28-Feb-2017CBR - 001326 / 09-May-2018Rtgs - 000048 / 10-May-2018,418065,369935,48130
147659,194-17-000063,Improvements to roads and drains at main road of Doctors layout in ward no 194,KRIDL9845154892,BR - 000168 / 31-Mar-2018CBR - 001531 / 18-May-2018Rtgs - 000055 / 21-May-2018,2416000,2108480,307520
155560,194-18-000018,Improvements to Drains at Kateramma layout in ward no 194,M/s KRIDL9880940728,BR - 000167 / 31-Mar-2018CBR - 001588 / 18-May-2018Rtgs - 000061 / 22-May-2018,4990750,4262620,728130
155562,194-18-000017,Improvements to road at Kateramma layout in ward no 194,M/s KRIDL9880940728,BR - 000166 / 31-Mar-2018CBR - 001589 / 18-May-2018Rtgs - 000061 / 22-May-2018,4938500,4216340,722160
55563,194-16-000022,Improvements to roads and drainages at Royal County Gottigere in ward no 194,a vijay kumar 9880545654,BR - 000149 / 12-Sep-2016CBR - 002127 / 02-Jun-2018Rtgs - 000071 / 06-Jun-2018,4246010,3640195,605815
108756,194-17-000029,Providing Drinking water supply through Tankers at Gottigere Village in ward no 194,nallur nagaraju9880940728,BR - 000157 / 30-Jun-2017CBR - 002332 / 11-Jun-2018Rtgs - 000079 / 11-Jun-2018,336640,299050,37590
51728,194-16-000026,Construction of culverts at Chaithanya layout in ward no 194,MUNIRAJU NAIK9141667771,BR - 000192 / 28-Oct-2016CBR - 002868 / 22-Jun-2018Rtgs - 000099 / 23-Jun-2018,724170,630560,93610
58518,194-17-000003,"Improvements to roads, drains and footpaths from Harinagara to Brookes heaven link road in ward no 194",KRIDL9980335777,BR - 000217 / 25-Nov-2016CBR - 003136 / 29-Jun-2018Rtgs - 000106 / 02-Jul-2018,9798919,8148319,1650600
64654,194-16-000021,Providing Additional water supply pipeline to existing yielded borewells in ward no 194,VIJAY KUMAR A9980123541,BR - 000219 / 28-Dec-2016CBR - 003084 / 29-Jun-2018Rtgs - 000107 / 02-Jul-2018,2399740,2092540,307200
63952,194-16-000020,Drilling of Borewells and water supply through tankers at Gottigere in ward no 194,RAVI KUMAR S8123401519,BR - 000220 / 28-Dec-2016CBR - 003085 / 29-Jun-2018Rtgs - 000107 / 02-Jul-2018,1111590,975120,136470
63950,194-16-000020,Drilling of Borewells and water supply through tankers at Gottigere in ward no 194,RAVI KUMAR S8123401519,BR - 000290 / 28-Mar-2017CBR - 003086 / 29-Jun-2018Rtgs - 000107 / 02-Jul-2018,1347570,1183800,163770
135454,194-17-000030,Providing Drinking water supply through Tankers at Weavers Colony and Pillaganhalli in ward no 194,Shivashankaraiah K N9611284153,BR - 000034 / 12-Jan-2018CBR - 003198 / 30-Jun-2018Rtgs - 000109 / 02-Jul-2018,1835200,1636720,198480
45034,194-15-000017,Emergency work in ward no 194,KARUNAKARAEDDY SMAAT INDIA PVT LTD9342307846,BR - 000178 / 20-Sep-2016CBR - 003426 / 07-Jul-2018Rtgs - 000117 / 09-Jul-2018,889248,871463,17785
137210,194-16-000001,Annual Operation and Maintenance of street lighting system in ward no-194 Package B11 of Bommanahalli zone.,M/s Sree Sreekanteswara Electricals9632977771,BR - 000050 / 12-Jan-2018CBR - 003754 / 13-Jul-2018Rtgs - 000127 / 18-Jul-2018,1299948,1126648,173300
60930,194-16-000025,Providing CC Roads at Weavers colony in ward no 194,UMESH H C9141667771,BR - 000244 / 03-Jan-2017CBR - 003827 / 16-Jul-2018Rtgs - 000128 / 18-Jul-2018,2321280,1988400,332880
159471,194-17-000066,Providing CC Camera at Garbage Block Spots in ward no 194,Sri M Taiyub Ahmed9845929841,BR - 000056 / 21-May-2018CBR - 004072 / 20-Jul-2018Rtgs - 000137 / 23-Jul-2018,862000,789600,72400
113203,194-17-000016,Providing chain link fencing and other developmental works to various parks at Deepak Layout in ward No. 194 Gottigere,KRIDL9999999999,BR - 000101 / 30-Mar-2017CBR - 005441 / 28-Aug-2018Rtgs - 000193 / 03-Sep-2018,4997885,4368145,629740
80441,194-17-000014,Providing Asphalting at Ragavendra layout at Gottigere ward no 194,KRIDL9980335777,BR - 000005 / 28-Apr-2017CBR - 005887 / 24-Sep-2018Rtgs - 000217 / 27-Sep-2018,2915140,2423040,492100
106988,194-17-000011,Improvements to roads and drains at Gottigere Doctors layout in ward no 194,KRIDL9845154892,BR - 000017 / 28-Apr-2017CBR - 005891 / 24-Sep-2018Rtgs - 000217 / 27-Sep-2018,4924000,4106260,817740
99929,194-17-000071,"Providing SV Lights, Tublar poll and other equipments from Koli farm Gate to Bilvaradahalli road near by Bannerghatta forest and surrounding areas in ward no 194",M/s Technical Manager- 01 KRIDL9632977771,BR - 000028 / 25-Jul-2017CBR - 005975 / 25-Sep-2018Rtgs - 000219 / 27-Sep-2018,4970085,4229535,740550
155565,194-17-000057,Improvements to roads and drains at Kothnur Village to Harinagara Mosque in ward no 194,KRIDL9845154892,BR - 000170 / 31-Mar-2018CBR - 006227 / 06-Oct-2018Rtgs - 000228 / 12-Oct-2018,3987600,3492250,495350
106864,194-17-000012,Improvements to roads and drains Bommaraju layaout and Nayak layout in ward no 194,KRIDL9845154892,BR - 000038 / 17-May-2017CBR - 006578 / 10-Oct-2018Rtgs - 000243 / 16-Oct-2018,4845800,4037540,808260
166698,194-18-000019,Improvements to Road and Drains at Ambedkar Colony near Puttamma house road in ward no 194 Gottigere,M/s KRIDL9880940728,BR - 000155 / 31-May-2018CBR - 006850 / 17-Oct-2018Rtgs - 000249 / 25-Oct-2018,4977000,4248650,728350
165998,194-18-000069,Drilling of borewell for Indira Kitchen and Construction of compound wall to Indira Canteen Kitchen in Gottigere in ward no.194 ,M/s KRIDL9448064004,BR - 000077 / 30-May-2018CBR - 007050 / 27-Oct-2018Rtgs - 000260 / 31-Oct-2018,2774200,2474800,299400
165994,194-18-000070,Development and providing allround chainlink fencing for Indira Canteen of Jambusavari Dinne in ward no.194 ,M/s KRIDL9448064004,BR - 000076 / 30-May-2018CBR - 007360 / 16-Nov-2018Rtgs - 000271 / 20-Nov-2018,2183700,1909720,273980
103545,194-16-000032,ImImprovements and Reparis to UGD Pipe line at weavers colony in ward no 194,S R GIRIRAJU9880940728,BR - 000071 / 31-May-2017CBR - 007439 / 17-Nov-2018Rtgs - 000279 / 03-Dec-2018,311800,272760,39040
102938,194-17-000001,Providing Improvements and cement concrete road at Pillaganahalli and Ambedkar colony in ward no 194,KRIDL9880940728,BR - 000073 / 31-May-2017CBR - 007440 / 17-Nov-2018Rtgs - 000279 / 03-Dec-2018,9714000,8093760,1620240
188679,194-17-000044,Construction of Culverts and drains at Jambusavaridinne Samudaya Bhavana Road in ward no 194,Sri B K Vinod Kumar9845222227,BR - 000264 / 15-Oct-2018CBR - 008263 / 27-Dec-2018Rtgs - 000308 / 01-Jan-2019,1939400,1817260,122140
111120,194-17-000025,Providing Name boards for Main and cross roads ward no 194,nallur nagaraju9880940728,BR - 000107 / 30-Jun-2017CBR - 009560 / 02-Mar-2019Rtgs - 000370 / 07-Mar-2019,1538675,1328345,210330
110500,194-17-000069,Improvements to drains at Nayak layout to Harinagara link road in ward no 194,KRIDL9845043439,BR - 000118 / 30-Jun-2017CBR - 009597 / 05-Mar-2019Rtgs - 000370 / 07-Mar-2019,4936150,4123760,812390
110511,194-17-000051,Improvements Roads and drains at Royal lake front Residency in ward no 194,KRIDL9845043439,BR - 000119 / 30-Jun-2017CBR - 009598 / 05-Mar-2019Rtgs - 000370 / 07-Mar-2019,4921170,4106800,814370
110491,194-17-000053,Improvements of Roads and drains at Jambusavari Dinne in ward no 194,KRIDL9845043439,BR - 000120 / 30-Jun-2017CBR - 009599 / 05-Mar-2019Rtgs - 000370 / 07-Mar-2019,4993150,4173070,820080
166700,194-18-000022,Improvements to Road and Drains at Samudaya Bhavan Road in Jambusavarai Dinne in ward no 194 Gottigere,M/s KRIDL9880940728,BR - 000157 / 31-May-2018CBR - 009650 / 12-Mar-2019Rtgs - 000379 / 20-Mar-2019,4973000,4245040,727960
108753,194-17-000021,"Engaging tractor labor for desilting and removal debries in roads and drains of Pillaganahalli Village, Maruthi layout and Surrounding areas in ward no 194",Nallur nagraju9880940728,BR - 000158 / 30-Jun-2017CBR - 009910 / 25-Mar-2019Rtgs - 000388 / 28-Mar-2019,365800,324990,40810
108750,194-17-000020,Engaging tractor labor for desilting and removal debries in roads and drains of Gottigere Village and Surrounding areas in ward no 194,nallur nagaraju9880940728,BR - 000159 / 30-Jun-2017CBR - 009916 / 25-Mar-2019Rtgs - 000388 / 28-Mar-2019,365800,321590,44210
189088,194-16-000001,Annual Operation and Maintenance of street lighting system in ward no-194 Package B11 of Bommanahalli zone.,M/s Sree Sreekanteswara Electricals9632977771,BR - 000028 / 28-Aug-2018CBR - 000384 / 11-Apr-2019Rtgs - 000017 / 12-Apr-2019,371414,330726,40688
189096,194-16-000001,Annual Operation and Maintenance of street lighting system in ward no-194 Package B11 of Bommanahalli zone.,M/s Sree Sreekanteswara Electricals9632977771,BR - 000029 / 28-Aug-2018CBR - 000385 / 11-Apr-2019Rtgs - 000017 / 12-Apr-2019,928534,832699,95835
222532,194-16-000001,Annual Operation and Maintenance of street lighting system in ward no-194 Package B11 of Bommanahalli zone.,M/s Sree Sreekanteswara Electricals9632977771,BR - 000072 / 18-Jan-2019CBR - 000834 / 23-Apr-2019Rtgs - 000029 / 25-Apr-2019,557121,483904,73217
222540,194-16-000001,Annual Operation and Maintenance of street lighting system in ward no-194 Package B11 of Bommanahalli zone.,M/s Sree Sreekanteswara Electricals9632977771,BR - 000075 / 19-Jan-2019CBR - 000836 / 23-Apr-2019Rtgs - 000029 / 25-Apr-2019,371414,324201,47213
124818,194-17-000027,Providing Improvements and CC Pavement to Roads in Weavers Colony and Maruthi layout in ward no 194,Mohan L9980489228,BR - 000019 / 30-Nov-2017CBR - 002181 / 28-May-2019Rtgs - 000065 / 30-May-2019,2361950,2072670,289280
247824,194-16-000001,Annual Operation and Maintenance of street lighting system in ward no-194 Package B11 of Bommanahalli zone.,M/s Sree Sreekanteswara Electricals9632977771,BR - 000007 / 17-May-2019CBR - 002348 / 01-Jun-2019Rtgs - 000073 / 07-Jun-2019,742828,644516,98312
250337,194-19-000045,Restoration of Road cut portion done by BWSSB -BESCOM-KPTCL in 194 in Bengaluru South Division roads under BBMP Limits Phase-1,M Ramesh9845057449,BR - 000069 / 29-May-2019CBR - 002546 / 07-Jun-2019Rtgs - 000081 / 13-Jun-2019,9906000,9411170,494830
243190,194-19-000009,Improvements to Roads and drains at weavers colony 3rd and 4th Cross Bande area in Ward No 194,M/s KRIDL9343728241,BR - 000040 / 30-Apr-2019CBR - 002962 / 24-Jun-2019Rtgs - 000097 / 01-Jul-2019,4929779,4219514,710265
268890,194-16-000001,Annual Operation and Maintenance of street lighting system in ward no-194 Package B11 of Bommanahalli zone.,M/s Sree Sreekanteswara Electricals9632977771,BR - 000033 / 07-Aug-2019CBR - 004594 / 17-Aug-2019Rtgs - 000161 / 21-Aug-2019,557121,483904,73217
153636,194-18-000003,Providing Asphalting at South Avenue in ward no 194 Gottigere,M/s KRIDL9880940728,BR - 000163 / 28-Mar-2018CBR - 004549 / 16-Aug-2019Rtgs - 000166 / 27-Aug-2019,4995600,4270980,724620
153627,194-18-000002,Improvements to drains at South Avenue in ward no 194 Gottigere,M/s KRIDL9880940728,BR - 000164 / 28-Mar-2018CBR - 004550 / 16-Aug-2019Rtgs - 000166 / 27-Aug-2019,4972750,4277330,695420
155566,194-17-000015,Improvements of roads and drains in pavamanagara at Pillaganahalli in ward no 194,KRIDL9845154892,BR - 000169 / 31-Mar-2018CBR - 004551 / 16-Aug-2019Rtgs - 000166 / 27-Aug-2019,1998600,1698220,300380
155961,194-18-000065,Improvements to roads and drains at Bhora layout in ward no 194,M/s KRIDL9880940728,BR - 000213 / 31-Mar-2018CBR - 004558 / 16-Aug-2019Rtgs - 000173 / 30-Aug-2019,4987500,4273650,713850
155960,194-18-000066,Improvements to roads and drains atJyothinagara in ward no 194,M/s KRIDL9845154892,BR - 000214 / 31-Mar-2018CBR - 004559 / 16-Aug-2019Rtgs - 000173 / 30-Aug-2019,4979000,4252950,726050
166650,194-11-000079,CONSTRUCTION OF HOUSES IN VADDARAPALYA SC/ST COLONY IN WARD NO 194 ( 10 NOS ),Venkatakrishna9141648915,BR - 000149 / 31-May-2018CBR - 004510 / 16-Aug-2019Rtgs - 000181 / 11-Sep-2019,1253935,1116085,137850
190104,194-17-000042,Improvements of Roads and drains at Kateramma layout in ward no 194,Sri B K Vinod Kumar9845222227,BR - 000342 / 28-Dec-2018CBR - 005137 / 16-Sep-2019Rtgs - 000202 / 26-Sep-2019,1939000,1822974,116026
190105,194-17-000045,Providing and fixing of Street Name boards in ward no 194,Sri B K Vinod Kumar9845222227,BR - 000020 / 29-Apr-2019CBR - 005138 / 16-Sep-2019Rtgs - 000202 / 26-Sep-2019,968500,909506,58994
190106,194-17-000043,Providing water Supply Through Tankers at Gottigere and Surrounding area in ward no 194,Sri B K Vinod Kumar9845222227,BR - 000019 / 29-Apr-2019CBR - 005139 / 16-Sep-2019Rtgs - 000202 / 26-Sep-2019,1938060,1860132,77928
260869,194-19-000008,Improvements to Roads and drains at weavers colony 8th Cross Gutte area in Ward No 194,M/s KRIDL9535051863,BR - 000122 / 05-Aug-2019CBR - 005638 / 03-Oct-2019Rtgs - 000217 / 11-Oct-2019,4931100,4221020,710080
238626,194-17-000065,Engagement of Gangman and Hiring of Tractor Tippers for cleaning and Maintenance of road side drains and other cleaning works in works in ward no 194,Sri N Nagaraju9800940728,BR - 000017 / 27-Apr-2019CBR - 005755 / 11-Oct-2019Rtgs - 000220 / 14-Oct-2019,1105700,989395,116305
145111,194-17-000002,Providing and Improvements and developmental works at Muneshwara layout and Royal lake front Residency in Raghavanapalya in ward no 194,KRIDL1230456789,BR - 000099 / 28-Feb-2018CBR - 006186 / 12-Nov-2019Rtgs - 000273 / 20-Nov-2019,9719500,8334240,1385260
165578,194-17-000024,Providing New Street lights in ward no 194,M/s. Shree hari Electrial7892710027,BR - 000007 / 07-Jun-2018CBR - 006229 / 14-Nov-2019Rtgs - 000277 / 26-Nov-2019,1258462,1203077,55385
293325,194-16-000001,Annual Operation and Maintenance of street lighting system in ward no-194 Package B11 of Bommanahalli zone.,M/s Sree Sreekanteswara Electricals9632977771,BR - 000044 / 14-Nov-2019CBR - 006336 / 22-Nov-2019Rtgs - 000278 / 26-Nov-2019,557120,473071,84049
164300,194-18-000064,"Improvements of Roads and Drains from Weavers Colony to Bilwaradahalli Road Ward no. 194, Gottigere",M/s KRIDL9845154892,BR - 000094 / 30-May-2018CBR - 006574 / 03-Dec-2019Rtgs - 000303 / 16-Dec-2019,4990750,4316550,674200
164309,194-18-000062,Providing Asphalting at B K Circle to Samudaya Bhavana road in ward no 194,M/s KRIDL9845154892,BR - 000095 / 30-May-2018CBR - 006575 / 03-Dec-2019Rtgs - 000303 / 16-Dec-2019,4971200,4294860,676340
166703,194-18-000005,Improvements to roads and drains at Maruthi layout in ward no 194 Gottigere,M/s KRIDL9880940728,BR - 000156 / 31-May-2018CBR - 006820 / 13-Dec-2019Rtgs - 000327 / 04-Jan-2020,4956000,4229650,726350
172790,194-18-000025,Providing Chain link Fencing at Royal County Park in ward no 194,KRIDL9999999999,BR - 000019 / 27-Jun-2018CBR - 007457 / 16-Jan-2020Rtgs - 000348 / 16-Jan-2020,4999629,4583661,415968
172767,194-18-000026,Providing Children Play Equipments Royal County Park in ward no 194,KRIDL 9999999999,BR - 000020 / 27-Jun-2018CBR - 007459 / 16-Jan-2020Rtgs - 000348 / 16-Jan-2020,2499166,2284513,214653
172777,194-18-000027,Providing seiner Citizen GYM Equipments Royal County Park in ward no 194,KRIDL9999999999,BR - 000021 / 27-Jun-2018CBR - 007462 / 16-Jan-2020Rtgs - 000348 / 16-Jan-2020,2499602,2280674,218928
155660,194-17-000013,Improvements to roads and drains at weavers colony in ward no 194,KRIDL9845154892,BR - 000174 / 31-Mar-2018CBR - 008562 / 15-Feb-2020Rtgs - 000406 / 25-Feb-2020,4909000,4303705,605295
290213,194-19-000012,Construction of Sumudaya Bhavana at Gottigere in Ward No 194,M/s KRIDL9980335777,BR - 000241 / 11-Dec-2019CBR - 008927 / 11-Mar-2020Rtgs - 000430 / 13-Mar-2020,9898580,8551970,1346610
166618,194-17-000052,Improvements of Roads and drains at Weavers Colony Bande area in ward no 194,KRIDL9845043439,BR - 000150 / 31-May-2018CBR - 008981 / 12-Mar-2020Rtgs - 000017 / 19-May-2020,4901533,4176137,725396
183001,194-18-000049,Improvements to roads and drains at Kothnur dinne Opp (BWSSB) Road in ward no 194,Sri G Thimme Gowda9448644063,BR - 000197 / 10-Aug-2018CBR - 009078 / 17-Mar-2020Rtgs - 000022 / 21-May-2020,1379000,1217590,161410
183002,194-18-000050,Improvements to roads and drains at Columbia Collage near Roya Lake Front Residency in ward no 194,Sri G Thimme Gowda9448644063,BR - 000198 / 10-Aug-2018CBR - 009079 / 17-Mar-2020Rtgs - 000022 / 21-May-2020,1406300,1231850,174450
183018,194-18-000051,Improvements to roads and drains at Kothnur dinne in ward no 194,G Thimme Gowda9448644063,BR - 000199 / 10-Aug-2018CBR - 009080 / 17-Mar-2020Rtgs - 000022 / 21-May-2020,1408400,1234800,173600
182992,194-18-000057,Improvements to roads and drains at Pillaganahalli in ward no 194,G Thimme Gowda9448644063,BR - 000200 / 10-Aug-2018CBR - 009081 / 17-Mar-2020Rtgs - 000022 / 21-May-2020,1877800,1643940,233860
182998,194-18-000052,Improvements to roads and drains at Raghavendra layout in ward no 194,G Thimme Gowda9448644063,BR - 000201 / 10-Aug-2018CBR - 009082 / 17-Mar-2020Rtgs - 000022 / 21-May-2020,1408800,1232700,176100
183029,194-18-000053,Improvements to roads and drains at Harinagara in ward no 194,D Y Naveen9845710489,BR - 000202 / 10-Aug-2018CBR - 009083 / 17-Mar-2020Rtgs - 000022 / 21-May-2020,1464000,1284230,179770
183322,194-18-000054,Improvements to roads and drains at Jambusavari Dinne in ward no 194,D Y Naveen9845710489,BR - 000203 / 10-Aug-2018CBR - 009084 / 17-Mar-2020Rtgs - 000023 / 21-May-2020,1448300,1269900,178400
183033,194-18-000055,Improvements to roads and drains at Ashraya Colony in ward no 194,D Y Naveen9845710489,BR - 000204 / 10-Aug-2018CBR - 009085 / 17-Mar-2020Rtgs - 000023 / 21-May-2020,1462290,1282640,179650
183020,194-18-000048,Providing CC Roads at Venkateshwara layout in ward no 194,Sri G Thimme Gowda9448644063,BR - 000196 / 10-Aug-2018CBR - 009086 / 17-Mar-2020Rtgs - 000023 / 21-May-2020,1402600,1228280,174320
331103,194-16-000001,Annual Operation and Maintenance of street lighting system in ward no-194 Package B11 of Bommanahalli zone.,M/s Sree Sreekanteswara Electricals9632977771,BR - 000001 / 13-Apr-2020CBR - 000469 / 28-May-2020Rtgs - 000056 / 02-Jun-2020,928534,816680,111854
107824,194-17-000047,Providing Asphalting to roads at Kemabathalli Venkateshwara Layout in ward no 194,KRIDL9845183166,BR - 000146 / 30-Jun-2017CBR - 001266 / 25-Jun-2020Rtgs - 000116 / 02-Jul-2020,4908000,4091420,816580
110318,194-17-000046,Providing CC drains and culverts Kembathalli Venkateshwara Layout in ward no 194,KRIDL9845183166,BR - 000033 / 03-May-2017CBR - 001267 / 25-Jun-2020Rtgs - 000116 / 02-Jul-2020,4907000,4090555,816445
151044,194-17-000026,Providing Improvements and Asphalting to ward roads in Gottigere Village and Jambusavarai Dinne in ward no 194,nallur nagaraju9880940728,BR - 000183 / 31-Mar-2018CBR - 001280 / 25-Jun-2020Rtgs - 000117 / 03-Jul-2020,1912000,1656170,255830
176017,194-18-000006,Improvements to roads and drains at Puttamma house road Ambedkar Colony layout in ward no 194 Gottigere,M/s KRIDL9880940728,BR - 000178 / 09-Jul-2018CBR - 001305 / 25-Jun-2020Rtgs - 000117 / 03-Jul-2020,4977000,4248150,728850
155635,194-17-000021,"Engaging tractor labor for desilting and removal debries in roads and drains of Pillaganahalli Village, Maruthi layout and Surrounding areas in ward no 194",Nallur nagraju9880940728,BR - 000184 / 31-Mar-2018CBR - 001619 / 06-Jul-2020Rtgs - 000147 / 10-Jul-2020,1591100,1419240,171860
342532,194-16-000001,Annual Operation and Maintenance of street lighting system in ward no-194 Package B11 of Bommanahalli zone.,M/s Sree Sreekanteswara Electricals9632977771,BR - 000024 / 07-Jun-2020CBR - 001644 / 07-Jul-2020Rtgs - 000156 / 14-Jul-2020,371414,326373,45041
223356,194-17-000009,Improvements to Roads and Drains at Gottigere Manjunatha layout (Hosa colony) in ward no 194,KRIDL9986096015,BR - 000405 / 13-Feb-2019CBR - 001501 / 03-Jul-2020Rtgs - 000182 / 20-Jul-2020,2449620,2081560,368060
244499,194-18-000021,Drilling of New Borewells and Errection of Pumpset at Tippu Cricle Krishnappa layout and Pillaganahalli in Ward no 194 Gottigere,M/s KRIDL9880940728,BR - 000080 / 31-May-2019CBR - 001502 / 03-Jul-2020Rtgs - 000182 / 20-Jul-2020,4126920,3599980,526940
352850,194-19-000020,Improvements and Construction of Compound wall at Jambusavari Dinne Burrial Ground in ward no 194,Cheluvaraju D8497856286,BR - 000135 / 18-Jul-2020CBR - 002351 / 17-Oct-2020Rtgs - 000197 / 20-Oct-2020,4405750,3971115,434635
329178,194-20-000026,Improvements to roads and drains at Royal Lake Front in ward no 194 Gottigere Annex 02 Sl No 868,M/s KRIDL9480828220,BR - 000323 / 23-Mar-2020CBR - 002470 / 21-Oct-2020Rtgs - 000199 / 22-Oct-2020,9830195,8872245,957950
330358,194-20-000003,Improvements to roads and drains at Pillaganahalli SC-ST colonies in Gottigere Ward 194,M/s KRIDL9480828220,BR - 000337 / 30-Mar-2020CBR - 002501 / 21-Oct-2020Rtgs - 000199 / 22-Oct-2020,9769800,8862715,907085
330711,194-20-000004,Improvements to roads and drains at Maruthi layout SC-ST colonies in Ward No194,M/s KRIDL9480828220,BR - 000345 / 31-Mar-2020CBR - 002514 / 21-Oct-2020Rtgs - 000199 / 22-Oct-2020,9785300,8914200,871100
330706,194-20-000006,Improvements to roads and drains at Shammana layout SC-ST colonies in Ward No194,M/s KRIDL9480828220,BR - 000346 / 31-Mar-2020CBR - 002515 / 21-Oct-2020Rtgs - 000199 / 22-Oct-2020,9786850,8901930,884920
330694,194-20-000002,Improvements to roads and drains at Gottigere SC-ST colonies Ward 194,M/s KRIDL9480828220,BR - 000347 / 31-Mar-2020CBR - 002516 / 21-Oct-2020Rtgs - 000199 / 22-Oct-2020,9788900,8911290,877610
330672,194-20-000024,Improvements to roads and drains at Pavamana Nagar in ward no 194 Gottigere Annex 02 Sl No 866,M/s KRIDL9480828220,BR - 000344 / 31-Mar-2020CBR - 002531 / 21-Oct-2020Rtgs - 000199 / 22-Oct-2020,19685100,17842170,1842930
354990,194-19-000031,Providing water fountan in Royal Park in ward no 194,"Executive Engineer-1, M/s KRIDL9480828220",BR - 000173 / 19-Aug-2020CBR - 002799 / 20-Nov-2020Rtgs - 000213 / 25-Nov-2020,248830,226845,21985
384888,194-16-000001,Annual Operation and Maintenance of street lighting system in ward no-194 Package B11 of Bommanahalli zone.,M/s Sree Sreekanteswara Electricals9632977771,BR - 000047 / 18-Nov-2020CBR - 003089 / 30-Nov-2020Rtgs - 000218 / 01-Dec-2020,742827,649943,92884
105591,194-16-000006,Improvements to roads and drains at Weavers Colony 5th and 6th Cross in ward no 194,MANJUNATHA K9845183166,BR - 000196 / 28-Oct-2016CBR - 002190 / 24-Sep-2020Rtgs - 000221 / 04-Dec-2020,1984570,1698590,285980
337319,194-20-000046,Improvements to roads and drains at Weavers Colony in ward no 194,"Executive Engineer-2, M/s KRIDL9480828220",BR - 000061 / 22-May-2020CBR - 003126 / 01-Dec-2020Rtgs - 000222 / 05-Dec-2020,9895500,8931415,964085
331958,194-20-000028,Improvements to roads and drains at Classic layout Back Side in ward no 194 Gottigere Annex 02 Sl No 870,M/s KRIDL9480828220,BR - 000007 / 27-Apr-2020CBR - 003524 / 22-Dec-2020Rtgs - 000239 / 24-Dec-2020,9828170,8880845,947325
331954,194-20-000038,Improvements to roads and drains at Krishnappa layout in ward no 194 Gottigere Annex 02 Sl No 880,M/s KRIDL9480828220,BR - 000008 / 27-Apr-2020CBR - 003525 / 22-Dec-2020Rtgs - 000239 / 24-Dec-2020,9814605,8822935,991670
331956,194-20-000032,Improvements to roads and drains at Rajathadri layout in ward no 194 Gottigere Annex 02 Sl No 874,M/s KRIDL9480828220,BR - 000009 / 27-Apr-2020CBR - 003529 / 22-Dec-2020Rtgs - 000239 / 24-Dec-2020,9829745,8884380,945365
331959,194-20-000031,Improvements to roads and drains at Gottigere in ward no 194 Gottigere Annex 02 Sl No 873,M/s KRIDL9480828220,BR - 000010 / 27-Apr-2020CBR - 003530 / 22-Dec-2020Rtgs - 000239 / 24-Dec-2020,9821700,8877030,944670
332139,194-20-000025,Improvements to roads and drains at Subrahi nagara in ward no 194 Gottigere Annex 02 Sl No 867,M/s KRIDL9480828220,BR - 000011 / 27-Apr-2020CBR - 003531 / 22-Dec-2020Rtgs - 000239 / 24-Dec-2020,9827600,8856745,970855
330732,194-20-000036,Improvements to roads and drains at IDBI layout in ward no 194 Gottigere Annex 02 Sl No 878,M/s KRIDL9480828220,BR - 000015 / 28-Apr-2020CBR - 003536 / 22-Dec-2020Rtgs - 000239 / 24-Dec-2020,9812310,8867440,944870
331100,194-20-000029,Improvements to roads and drains at Mahaganapathi layout in ward no 194 Gottigere Annex 02 Sl No 871,M/s KRIDL9480828220,BR - 000016 / 28-Apr-2020CBR - 003537 / 22-Dec-2020Rtgs - 000239 / 24-Dec-2020,9669680,8750745,918935
327588,194-20-000027,Improvements to roads and drains at Raghavanapalya in ward no 194 Gottigere Annex 02 Sl No 869,M/s KRIDL9480828220,BR - 000320 / 20-Mar-2020CBR - 003559 / 22-Dec-2020Rtgs - 000239 / 24-Dec-2020,9836555,8931365,905190
332534,194-20-000005,Improvements to roads and drains at Ambedkar layout SC-ST colonies in Ward No194,M/s KRIDL9480828220,BR - 000028 / 30-Apr-2020CBR - 003573 / 23-Dec-2020Rtgs - 000240 / 24-Dec-2020,9804350,8814385,989965
379036,194-20-000072,Providing UGD Pipe line at Lakshman Layout Ashraya colony and Vaddara Palya in wardno 194 Gottigere,"K Uday Kumar, M/s Raghavendra Civil Projects9845183166",BR - 000234 / 28-Oct-2020CBR - 003987 / 02-Jan-2021Rtgs - 000251 / 08-Jan-2021,9910000,8949465,960535
155641,194-17-000020,Engaging tractor labor for desilting and removal debries in roads and drains of Gottigere Village and Surrounding areas in ward no 194,nallur nagaraju9880940728,BR - 000185 / 31-Mar-2018CBR - 002072 / 20-Jul-2020Rtgs - 000254 / 15-Jan-2021,1592900,1420830,172070
378971,194-19-000024,Providing Water Pipeline in Gottigere ward no 194,"Executive Engineer-1, M/s KRIDL9480828220",BR - 000244 / 05-Nov-2020CBR - 004138 / 30-Jan-2021Rtgs - 000267 / 02-Feb-2021,2356845,2157050,199795
378999,194-19-000030,Providing UGD Pipeline in ward no 194 Gottigere,"Executive Engineer-1, M/s KRIDL9480828220",BR - 000245 / 05-Nov-2020CBR - 004139 / 30-Jan-2021Rtgs - 000267 / 02-Feb-2021,747800,679890,67910
383764,194-19-000022,Improvements to roads and Construction of Footpath at Royal County in ward no 194,"Executive Engineer-1, M/s KRIDL9480828220",BR - 000259 / 23-Nov-2020CBR - 004199 / 30-Jan-2021Rtgs - 000267 / 02-Feb-2021,4919530,4447700,471830
394705,194-20-000069,Improvements roads and drains at Meenakshi layout in ward no 194,"Vasu Sevarthi, Ms Saanvi Earth Movers and Constructions9900007121",BR - 000362 / 24-Dec-2020CBR - 004422 / 22-Feb-2021Rtgs - 000281 / 25-Feb-2021,9420880,8342445,1078435
392928,194-20-000001,Improvements to roads and drains in Weavers colony SC-ST colonies at Gottigere in Ward 194,M/s KRIDL9480828220,BR - 000369 / 24-Dec-2020CBR - 004952 / 11-Mar-2021Rtgs - 000295 / 12-Mar-2021,9896500,8963095,933405
392996,194-20-000007,Improvements to roads and drains at Krishnappa layout SC-ST colonies in Ward No194,M/s KRIDL9480828220,BR - 000370 / 24-Dec-2020CBR - 004953 / 11-Mar-2021Rtgs - 000295 / 12-Mar-2021,9890800,8957870,932930
383093,194-19-000021,Maintenance of Burrial Ground at Gottigere in ward no 194,"Executive Engineer-1, M/s KRIDL9480828220",BR - 000302 / 07-Dec-2020CBR - 005117 / 16-Mar-2021Rtgs - 000302 / 23-Mar-2021,249500,224845,24655
397937,194-20-000067,Providing UGD Pipeline at Pillaganahalli Surrounding area in ward no 194,"Vasu Sevarthi, Ms Saanvi Earth Movers and Constructions9900007121",BR - 000403 / 13-Jan-2021CBR - 005139 / 16-Mar-2021Rtgs - 000302 / 23-Mar-2021,14215000,12517595,1697405
337006,194-20-000034,Improvements to roads and drains at Pillaganahalli in ward no 194 Gottigere Annex 02 Sl No 876,M/s KRIDL9480828220,BR - 000053 / 18-May-2020CBR - 005300 / 24-Mar-2021Rtgs - 000305 / 25-Mar-2021,11271255,10151870,1119385
348662,194-20-000035,Improvements to roads and drains at Weavers Colony in ward no 194 Gottigere Annex 02 Sl No 877,M/s KRIDL9480828220,BR - 000125 / 03-Jul-2020CBR - 005630 / 27-Mar-2021Rtgs - 000319 / 29-Mar-2021,9804120,8856055,948065
349902,194-20-000034,Improvements to roads and drains at Pillaganahalli in ward no 194 Gottigere Annex 02 Sl No 876,M/s KRIDL9480828220,BR - 000126 / 13-Jul-2020CBR - 005675 / 27-Mar-2021Rtgs - 000319 / 29-Mar-2021,8383155,7541410,841745
348686,194-20-000021,Improvements to roads and drains at Classic layout in ward no 194 Gottigere Annex 02 Sl No 862,M/s KRIDL9480828220,BR - 000146 / 28-Jul-2020CBR - 005739 / 28-Mar-2021Rtgs - 000319 / 29-Mar-2021,19606345,17662630,1943715
348710,194-20-000030,Improvements to roads and drains at Bhora layout in ward no 194 Gottigere Annex 02 Sl No 872,M/s KRIDL9480828220,BR - 000147 / 28-Jul-2020CBR - 005740 / 28-Mar-2021Rtgs - 000319 / 29-Mar-2021,19601225,17710750,1890475
353230,194-20-000033,Improvements to roads and drains at Maruthi layout in ward no 194 Gottigere Annex 02 Sl No 875,M/s KRIDL9480828220,BR - 000151 / 29-Jul-2020CBR - 005741 / 28-Mar-2021Rtgs - 000319 / 29-Mar-2021,9828300,8830475,997825
166706,194-17-000017,Maintenance of bore wells and water supply System in ward no 194,N Nagaraju9448064004,BR - 000158 / 31-May-2018CBR - 005147 / 17-Mar-2021Rtgs - 000323 / 30-Mar-2021,3345000,2980210,364790
397372,194-19-000023,Improvements to footpath at Pavamananagara in ward no 194,"Executive Engineer-1, M/s KRIDL9480828220",BR - 000466 / 18-Mar-2021CBR - / Rtgs - 000014 / 30-Apr-2021,749315,687065,62250
204114,194-17-000022,Reconstruction of Damaged Culverts and drains in ward no 194,Nallur Nagaraju9880940728,BR - 000332 / 13-Dec-2018CBR - / Rtgs - 000016 / 03-May-2021,1950000,1698828,251172
204105,194-17-000018,Maintenance of UGD and Providing Missed links in Villages of ward no 194,N Nagaraj9448064004,BR - 000333 / 15-Dec-2018CBR - / Rtgs - 000018 / 04-May-2021,4058480,3560108,498372
204107,194-17-000023,Drilling of New Bore well and errection of pumsets and providing Pipe line with electrification in ward no 194,N K MOHAN MURALI9845154892,BR - 000334 / 15-Dec-2018CBR - / Rtgs - 000018 / 04-May-2021,3776600,3364920,411680
212326,194-18-000056,Providing CC Roads at Maruthi layout in ward no 194,Sri K G Ramachandra9036974187,BR - 000340 / 27-Dec-2018CBR - / Rtgs - 000019 / 05-May-2021,1411200,1238130,173070
371356,194-20-000013,Improvements to drains and Asphalting to road from Jambusavari Dinne to BK circle in ward no. 194 Gottigere,The Executive Engineer 1 9986072837,BR - 000010 / 24-Sep-2020CBR - / Rtgs - 000020 / 05-May-2021,19964581,17794958,2169623
218147,194-18-000043,Maintenance of UGD at Gottigere and Surrounding areas in ward no 194,Sri N Nagaraju9448064004,BR - 000372 / 09-Jan-2019CBR - / Rtgs - 000053 / 01-Jun-2021,2377434,2097429,280005
218146,194-18-000047,Emergency of work in ward no 194,Sri S R Giriraju9980335777,BR - 000374 / 09-Jan-2019CBR - / Rtgs - 000053 / 01-Jun-2021,1882800,1649955,232845
218145,194-18-000044,Providing UGD Missed links in ward no 194,Sri N Nagaraju9448064004,BR - 000375 / 09-Jan-2019CBR - / Rtgs - 000053 / 01-Jun-2021,1899960,1678030,221930
362647,194-20-000037,Improvements to roads and drains at Royal County in ward no 194 Gottigere Annex 02 Sl No 879,M/s KRIDL9480828220,BR - 000197 / 11-Sep-2020CBR - / Rtgs - 000054 / 01-Jun-2021,9869000,8866570,1002430
218031,194-18-000059,"Providing Drinking water Supply Through Tankers at Weavers Colony, Pillaganahalli and Surrounding area in ward no 194",Sri S R Giriraju9980335777,BR - 000371 / 09-Jan-2019CBR - / Rtgs - 000067 / 08-Jun-2021,1908630,1708275,200355
218028,194-18-000058,Providing Drinking water Supply Through Tankers at Gottigere and Surrounding area in ward no 194,Sri S R Giriraju9980335777,BR - 000373 / 09-Jan-2019CBR - / Rtgs - 000067 / 08-Jun-2021,1890114,1691414,198700
218149,194-18-000076,Improvements to drain and roads of Meenakshi Layout in ward no 194,M/s KRIDL9880940728,BR - 000404 / 13-Feb-2019CBR - / Rtgs - 000067 / 08-Jun-2021,4491900,3845615,646285
227933,194-17-000028,Providing CC Pavement to roads in Pillaganahalli Village in ward no 194,Francis A9036718749,BR - 000413 / 27-Feb-2019CBR - / Rtgs - 000071 / 10-Jun-2021,1910160,1654900,255260
337307,194-20-000048,Improvements to roads and drains at Weavers colony 5th Cross Bande area in ward no 194,Executive Engineer-1 M/s KRIDL9480828220,BR - 000059 / 22-May-2020CBR - / Rtgs - 000107 / 16-Jul-2021,9902300,8937730,964570
337340,194-20-000043,Improvements to roads and drains at Pillaganahalli Near RO Plant in ward no 194,Executive Engineer-1 M/s KRIDL9480828220,BR - 000060 / 22-May-2020CBR - / Rtgs - 000107 / 16-Jul-2021,9897130,8929425,967705
337797,194-20-000047,Improvements to cross roads and drains at BTS Layout in ward no 194,Executive Engineer-1 M/s KRIDL9480828220,BR - 000062 / 22-May-2020CBR - / Rtgs - 000107 / 16-Jul-2021,9900500,8935760,964740
344146,194-20-000050,Improvements to roads and drains at Pillaganahalli Eidgha Masjid road in ward no 194,"Executive Engineer-1, M/s KRIDL9480828220",BR - 000090 / 16-Jun-2020CBR - / Rtgs - 000107 / 16-Jul-2021,9874390,8887455,986935
342925,194-20-000049,Improvements to roads and drains at Kothnur Dinne Surrounding area in ward no 194,Executive Engineer-1 M/s KRIDL9480828220,BR - 000091 / 16-Jun-2020CBR - / Rtgs - 000107 / 16-Jul-2021,9881550,8914450,967100
344192,194-20-000051,Improvements to roads and drains at Puttamma House road near Noorani Masjid ward no 194,Executive Engineer-1 M/s KRIDL9480828220,BR - 000093 / 18-Jun-2020CBR - / Rtgs - 000107 / 16-Jul-2021,9822545,8828685,993860
243189,194-18-000037,Improvements to roads and drains at royal lake front residency layout in ward No 194,M/s KRIDL9880940728,BR - 000042 / 30-Apr-2019CBR - / Rtgs - 000114 / 22-Jul-2021,4952375,4237555,714820
238638,194-18-000042,Maintenance of Borewells in Pillaganahalli and Surrounding area in ward no 194,Sri N Nagaraju9448064404,BR - 000016 / 27-Apr-2019CBR - / Rtgs - 000115 / 23-Jul-2021,1969900,1752504,217396
238631,194-18-000041,Maintenance of Borewells in Gottiegere and Surrounding area in ward no 194,Sri N Nagaraju9448064004,BR - 000018 / 27-Apr-2019CBR - / Rtgs - 000115 / 23-Jul-2021,1975350,1765270,210080
155631,194-17-000029,Providing Drinking water supply through Tankers at Gottigere Village in ward no 194,nallur nagaraju9880940728,BR - 000041 / 30-Apr-2019CBR - / Rtgs - 000115 / 23-Jul-2021,1656260,1477650,178610
247131,194-18-000024,Drilling of 165mm Dia New Borewell 4 Nos And Providing electrification and Disturbution of Pipe line at Gottigere surrounding area in ward no 194,M/s KRIDL9448475620,BR - 000086 / 17-Jun-2019CBR - / Rtgs - 000116 / 23-Jul-2021,3936562,3438261,498301
247148,194-18-000023,Drilling of 165mm Dia New Borewell 4 Nos And Providing electrification and Disturbution of Pipe line at Gottigere in ward no 194,M/s KRIDL9448475620,BR - 000085 / 17-Jun-2019CBR - / Rtgs - 000116 / 23-Jul-2021,3937013,3438736,498277
380378,194-20-000034,Providing Consultancy Services for Preparation of Project Management Consultancy (PMC) for the works of (1) Improvements to roads and drains at Bhora layout in ward no 194 Gottigere (GO SL No 872) (2) Improvements to roads and drains at Rajathadri layout in ward no 194 Gottigere (GO Sl No 874) (3) Improvements to roads and drains at Maruthi layout in ward no 194 Gottigere (GO Sl No 875) (4) Improvements to roads and drains at Pillaganahalli in ward no 194 Gottigere (GO Sl No 876). ,M/s VSR Infra Pvt. Ltd.9845230975,BR - 000249 / 09-Nov-2020CBR - / Rtgs - 000125 / 29-Jul-2021,478000,430200,47800
361185,194-20-000025,Providing Consultancy Services for Preparation of Detailed Project Report (DPR) for the work of (1) Improvements to roads and drains at Subrahi nagara in ward no 194 Gottigere (GO SL No 867) (2) Improvements to roads and drains at Royal Lake Front in ward no 194 Gottigere (GO Sl No 868) (3) Improvements to roads and drains at Raghavanapalya in ward no 194 Gottigere (GO Sl No 869) (4) Improvements to roads and drains at Classic layout Back Side in ward no 194 Gottigere (GO Sl No 870) (5) Improvements to roads and drains at Mahaganapathi layout in ward no 194 Gottigere (GO Sl No 871) (6) Improvements to roads and drains at Gottigere in ward no 194 Gottigere (GO Sl No 873).,M/s Unique Engineering & Management Consultancy9738120334,BR - 000345 / 19-Dec-2020CBR - / Rtgs - 000125 / 29-Jul-2021,455000,409500,45500
361198,194-20-000032,Providing Consultancy Services for Preparation of Detailed Project Report (DPR) for the work of (1) Improvements to roads and drains at Bhora layout in ward no 194 Gottigere (GO SL No 872) (2) Improvements to roads and drains at Rajathadri layout in ward no 194 Gottigere (GO Sl No 874) (3) Improvements to roads and drains at Maruthi layout in ward no 194 Gottigere (GO Sl No 875) (4) Improvements to roads and drains at Pillaganahalli in ward no 194 Gottigere (GO Sl No 876). ,M/s Unique Engineering & Management Consultancy9738120334,BR - 000346 / 19-Dec-2020CBR - / Rtgs - 000125 / 29-Jul-2021,455000,409500,45500
361192,194-20-000036,Providing Consultancy Services for Preparation of Detailed Project Report (DPR) for the work of (1) Improvements to roads and drains at Weavers Colony in ward no 194 Gottigere (GO Sl No 877). (2) Improvements to roads and drains at IDBI layout in ward no 194 Gottigere (GO Sl No 878) (3) Improvements to roads and drains at Royal County in ward no 194 Gottigere (GO Sl No 879) (4) Improvements to roads and drains at Krishnappa layout in ward no 194 Gottigere (GO Sl No 880) (5) Improvements to roads and drains at Vaddarapalya in ward no 194 Gottigere (GO Sl No 881).,M/s Unique Engineering & Management Consultancy9738120334,BR - 000347 / 19-Dec-2020CBR - / Rtgs - 000125 / 29-Jul-2021,379000,341100,37900
361189,194-20-000024,Providing Consultancy Services for Preparation of Detailed Project Report (DPR) for the work of (1) Improvements to roads and drains at Classic layout in ward no 194 Gottigere (GO Sl No 862) (2) Improvements to roads and drains at South Avenue layout in ward no 194 Gottigere (GO Sl No 865) (3) Improvements to roads and drains at Pavamana Nagar in ward no 194 Gottigere (GO SL No 866),M/s Unique Engineering & Management Consultancy9738120334,BR - 000349 / 19-Dec-2020CBR - / Rtgs - 000125 / 29-Jul-2021,450000,405000,45000
249292,194-17-000054,Improvements of Roads and drains at Krishnappa layout in ward no 194,KRIDL9880940728,BR - 000079 / 31-May-2019CBR - / Rtgs - 000130 / 02-Aug-2021,4948600,4218765,729835
249293,194-18-000067,Improvements to roads and drains at Venkateshwara layout in ward no 194,M/s KRIDL9880940728,BR - 000081 / 31-May-2019CBR - / Rtgs - 000130 / 02-Aug-2021,4975560,4251525,724035
249302,194-18-000060,Improvements roads and drains at Mahaganapathi layout in Gottigere ward no 194,M/s KRIDL9880940728,BR - 000082 / 31-May-2019CBR - / Rtgs - 000130 / 02-Aug-2021,4992550,4266180,726370
345750,194-19-000048,Providing Borewell water pipe lines Water Supply works at ward No.194,M/s KRIDL9880940728,BR - 000133 / 16-Jul-2020CBR - / Rtgs - 000162 / 18-Aug-2021,9074455,8326170,748285
269313,194-17-000038,"Providing Electrical maintenance, repair and replacement of damaged U.G cable and control panels with Accessories to parks in ward no-194 and 195.",M/s Mamatha Electrical 9880521227,BR - 000037 / 16-Aug-2019CBR - / Rtgs - 000188 / 14-Sep-2021,230417,217967,12450
360901,194-20-000041,Improvements to roads and drains at Weavers colony 9th Cross Bande area in ward no 194,"Executive Engineer-1, M/s KRIDL9480828220",BR - 000183 / 29-Aug-2020CBR - / Rtgs - 000224 / 05-Oct-2021,9996200,9009955,986245
240292,194-18-000015,Improvements to drains at South Avenue to Kembathalli Link Road in ward no 194,M/s KRIDL9880940728,BR - 000102 / 02-Jul-2019CBR - / Rtgs - 000225 / 05-Oct-2021,4846570,4143640,702930
240290,194-18-000011,Providing Asphalting to Nayak layout to Harinagara link road in ward no 194,M/s KRIDL9880940728,BR - 000103 / 02-Jul-2019CBR - / Rtgs - 000225 / 05-Oct-2021,4824340,4123525,700815
240286,194-18-000016,Providing Asphalting from South Avenue to Kemabathalli Link Road in ward no 194,M/s KRIDL9880940728,BR - 000104 / 02-Jul-2019CBR - / Rtgs - 000225 / 05-Oct-2021,4807880,4110040,697840
240284,194-18-000010,Improvements to roads and drains at Royal County Phase-2 in ward no 194,M/s KRIDL9880940728,BR - 000105 / 02-Jul-2019CBR - / Rtgs - 000225 / 05-Oct-2021,4843085,4139870,703215
240278,194-18-000009,Improvements to roads and drains at Royal County Phase-1 in ward no 194,M/s KRIDL9880940728,BR - 000106 / 02-Jul-2019CBR - / Rtgs - 000225 / 05-Oct-2021,4854750,4148305,706445
240274,194-18-000007,Providing Asphalting to BGS layout in ward no 194,M/s KRIDL9880940728,BR - 000107 / 02-Jul-2019CBR - / Rtgs - 000225 / 05-Oct-2021,4823160,4122830,700330
240272,194-18-000008,Improvements to roads and drains from G.R Apartment to Kothnur Dinne in ward no 194,M/s KRIDL9880940728,BR - 000108 / 02-Jul-2019CBR - / Rtgs - 000225 / 05-Oct-2021,4834360,4132410,701950
257090,194-20-000008,Providing Assured Minimum Facilities AMF to all polling Stations of Loksabha Election 2019 pertains to Ward No 194,Sri Rajanna M8618320478,BR - 000114 / 29-Jul-2019CBR - / Rtgs - 000227 / 07-Oct-2021,342510,328950,13560
249315,194-18-000004,Improvements to roads and drains at Muneshwara layout in ward no 194 Gottigere,M/s KRIDL9880940728,BR - 000129 / 08-Aug-2019CBR - / Rtgs - 000233 / 08-Oct-2021,4964075,4238105,725970
279505,194-19-000013,Construction of ward office in ward no 194 Gottigere,M/s KRIDL9980335777,BR - 000181 / 25-Sep-2019CBR - / Rtgs - 000241 / 12-Oct-2021,9948960,8610885,1338075
438675,194-20-000040,Annual Operation and Maintenance of street lighting system in ward no-194 Package B13 of Bommanahalli zone,SREE SRIKANTESWARA E9632977771,BR - 000014 / 30-Jun-2021CBR - / Rtgs - 000246 / 13-Oct-2021,814019,759774,54245
438671,194-16-000001,Annual Operation and Maintenance of street lighting system in ward no-194 Package B11 of Bommanahalli zone.,M/s Sree Sreekanteswara Electricals9632977771,BR - 000011 / 30-Jun-2021CBR - / Rtgs - 000246 / 13-Oct-2021,738068,647906,90162
452412,194-19-000027,Construction of Public Toilets at Jambusavari Dinne ward no 194,"Executive Engineer-1, M/s KRIDL9480828220",BR - 000166 / 19-Aug-2021CBR - / Rtgs - 000247 / 18-Oct-2021,2480750,2294740,186010
378019,194-19-000025,Drinking water Supply Through Tankers in ward no 194,"Executive Engineer-1, M/s KRIDL9480828220",BR - 000161 / 11-Aug-2021CBR - / Rtgs - 000247 / 18-Oct-2021,2499500,2343245,156255
438771,194-20-000070,Improvements roads and drains at Maruthi layout in ward no 194,Vasu Sevarthi (Saanvi Earth Movers and Constructions)9900007121,BR - 000106 / 30-Jun-2021CBR - / Rtgs - 000247 / 18-Oct-2021,13260400,11948898,1311502
380342,194-20-000026,Providing Consultancy Services for Preparation of Project Management Consultancy (PMC) for the works of (1) Improvements to roads and drains at Subrahi nagara in ward no 194 Gottigere (GO SL No 867) (2) Improvements to roads and drains at Royal Lake Front in ward no 194 Gottigere (GO Sl No 868) (3) Improvements to roads and drains at Raghavanapalya in ward no 194 Gottigere (GO Sl No 869) (4) Improvements to roads and drains at Classic layout Back Side in ward no 194 Gottigere (GO Sl No 870) (5) Improvements to roads and drains at Mahaganapathi layout in ward no 194 Gottigere (GO Sl No 871) (6) Improvements to roads and drains at Gottigere in ward no 194 Gottigere (GO Sl No 873).,M/s VSR Infra Pvt. Ltd.9845230975,BR - 000248 / 09-Nov-2020CBR - / Rtgs - 000252 / 25-Oct-2021,479000,431100,47900
431903,194-19-000015,Providing Asphalting to Kothanur Dinne in ward no 194,Executive Engineer-1 M/s KRIDL9480828220,BR - 000073 / 10-Jun-2021CBR - / Rtgs - 000283 / 04-Dec-2021,4991500,4579410,412090
465841,194-19-000028,Improvements of Existing Toilets at Gottigere in ward no 194,"Executive Engineer-1, M/s KRIDL9480828220",BR - 000196 / 07-Oct-2021CBR - / Rtgs - 000285 / 06-Dec-2021,249000,223280,25720
399876,194-19-000056,Emergency of Work in Ward No. 194,"Malolan A, M/s Sri Ranganatha Constructions7829871509",BR - 000402 / 13-Jan-2021CBR - / Rtgs - 000294 / 21-Dec-2021,1665100,1479660,185440
345684,194-19-000063,Providing Drinking water Supply Through Tankers at Gottigere and Surrounding area in ward no 194,N NAGARAJU9448064004,BR - 000109 / 30-Jun-2020CBR - / Rtgs - 000302 / 04-Jan-2022,1749950,1709575,40375
345695,194-19-000064,Providing Drinking water Supply Through Tankers at Weavers Colony Pillaganahalli and Surrounding area in ward no 194,N NAGARAJU9448064004,BR - 000110 / 30-Jun-2020CBR - / Rtgs - 000302 / 04-Jan-2022,1749950,1709575,40375
387592,194-20-000060,Improvements to roads and drains at Ramakrishnappa layout in ward no 194,NESHWARRAJU9945277738,BR - 000300 / 04-Dec-2020CBR - / Rtgs - 000308 / 11-Jan-2022,9943800,8905520,1038280
301173,194-19-000047,Improvements to roads and drains at Kothanoordinne in ward no 194 Gottigere,KRIDL BHUSIRI ACCOU0000000000,BR - 000249 / 30-Dec-2019CBR - / Rtgs - 000315 / 19-Jan-2022,9880180,8457640,1422540
274968,194-17-000010,Construction of New Helth care centre at Gottigere in ward no 194,GIRIRAJUSR9980335777,BR - 000161 / 31-Aug-2019CBR - / Rtgs - 000322 / 01-Feb-2022,9982835,9490105,492730
430955,194-20-000023,Providing Consultancy Services for Preparation of Project Management Consultancy (PMC) for the works of (1) Improvements to roads and drains at Classic layout in ward no 194 Gottigere (GO Sl No 862) (2) Improvements to roads and drains at South Avenue layout in ward no 194 Gottigere (GO Sl No 865) (3) Improvements to roads and drains at Pavamana Nagar in ward no 194 Gottigere (GO SL No 866), VEENASHIVAPPARAI CI9448463619,BR - 000071 / 07-Jun-2021CBR - / Rtgs - 000355 / 17-Feb-2022,478000,430200,47800
274777,194-19-000002,Asphalting to roads in Gottigere ward no 194,KRIDL BHUSIRI ACCOU0000000000,BR - 000180 / 24-Sep-2019CBR - / Rtgs - 000378 / 24-Feb-2022,4947325,4232195,715130
265126,194-18-000036,Improvements of roads and drains at Weavers Colony in Ward No 194 Gottigere,KRIDL BHUSIRI ACCOU0000000000,BR - 000189 / 30-Sep-2019CBR - / Rtgs - 000381 / 25-Feb-2022,4978830,4256665,722165
485121,194-20-000076,Providing RO plant and water supply system to Gottigee in ward no 194 ,SRI RAGHAVENDRA CIVI9845183166,BR - 000236 / 16-Dec-2021CBR - / Rtgs - 000415 / 17-Mar-2022,9653300,9165990,487310
485125,194-20-000073,Construction of public toilet to Gottigere in ward no 194 ,SRI RAGHAVENDRA CIVI9845183166,BR - 000237 / 16-Dec-2021CBR - / Rtgs - 000415 / 17-Mar-2022,5965300,5663176,302124
487383,194-20-000071,Providing water Supply System in ward no 194,SAANVI EARTH MOVERS 9900007121,BR - 000244 / 27-Dec-2021CBR - / Rtgs - 000415 / 17-Mar-2022,8627900,8196360,431540
476518,194-19-000026,Providing water supply line at Pillaganahalli Village in ward no 194,KRIDL BHUSIRI ACCOU0000000000,BR - 000213 / 17-Nov-2021CBR - / Rtgs - 000415 / 17-Mar-2022,997000,917900,79100
490474,194-20-000075,Improvements roads and drains at Lakshmana layout in ward no 194 Gottigere ,LOKESH R9845141339,BR - 000250 / 06-Jan-2022CBR - / Rtgs - 000422 / 23-Mar-2022,10208000,9643524,564476
490454,194-20-000074,Improvements roads and drains to Meenakshi layout Near Kembathahalli in ward no 194 Gottigere,LOKESH R9845141339,BR - 000251 / 06-Jan-2022CBR - / Rtgs - 000422 / 23-Mar-2022,10230400,9655034,575366
