id,wo num, wodetails,contractor,brnumber,amount,nett,deduction
11633,197-13-000008,Improvements and Widening of Road at Ramanjaneya Nagara main road and Cement Concrete to cross Roads in ward no. 197 Vasanthapura,Mahadevu C 9845511104,BR - 000103 / 30-Jun-2014CBR - 001793 / 01-Jun-2016Rtgs - 000045 / 04-Jun-2016,878600,761705,116895
11807,197-14-000003,IMPROVEMENTS TO ROADS AND DRAINS AT BRIGHT WAY LAYOUT IN WARD NO 197 VASANTHAPURA,Yogesh H R 9845750001,BR - 000113 / 30-Jun-2014CBR - 001804 / 01-Jun-2016Rtgs - 000045 / 04-Jun-2016,971732,828937,142795
11796,197-14-000018,IMPROVEMENTS TO CANARA BANK PARALLEL ROAD (BEHIND ROYAL SCHOOL) AT SIDDANA LAYOUT IN WARD NO 197 VASANTHAPURA,P Chamegowda9845750001,BR - 000114 / 30-Jun-2014CBR - 001869 / 03-Jun-2016Rtgs - 000049 / 09-Jun-2016,486115,420525,65590
11802,197-14-000006,PROVIDING UGD LINES AND MISSED LINKS AT NARAYANA NAGARA IN WARD NO 197 VASANTHAPURA,P Chamegowda9845750001,BR - 000115 / 30-Jun-2014CBR - 001870 / 03-Jun-2016Rtgs - 000049 / 09-Jun-2016,1222825,1065035,157790
11794,197-14-000002,PROVIDING UGD LINE TO MAIN ROAD OF VENKAREDDY LAYOUT IN WARD NO 197 VASANTHAPURA,P Chamegowda9845750001,BR - 000116 / 30-Jun-2014CBR - 001874 / 03-Jun-2016Rtgs - 000049 / 09-Jun-2016,981138,857213,123925
11941,197-14-000047,Providing UGD to Punjab national bank layout Narayana nagara and Doctors colony in ward no 197,KRIDL9986096015,BR - 000131 / 30-Jun-2014CBR - 001948 / 06-Jun-2016Rtgs - 000049 / 09-Jun-2016,4932085,4154990,777095
11943,197-13-000065,Providing UGD System culverts and Improvements to drains at Uma Maheshwari layout and Narayana nagara in ward no 197,KRIDL9986096015,BR - 000132 / 30-Jun-2014CBR - 001949 / 06-Jun-2016Rtgs - 000049 / 09-Jun-2016,2145030,1802995,342035
11923,197-13-000024,Providing Silt and Tractor in ward no 197 Vasanthapura,Vijay Kumar A 9986096015,BR - 000133 / 30-Jun-2014CBR - 001950 / 06-Jun-2016Rtgs - 000049 / 09-Jun-2016,1029830,894245,135585
11925,197-14-000004,ASPHALTING THE 1ST MAIN ROAD AT GANAPATHIPURA IN WARD NO 197 VASANTHAPURA,Vijay Kumar A 9986096015,BR - 000134 / 30-Jun-2014CBR - 001951 / 06-Jun-2016Rtgs - 000049 / 09-Jun-2016,520110,446105,74005
12529,197-14-000020,PROVIDING NEW UGD LINE TO CROSS ROADS OF VENKATAREDDY LAYOUIT IN WARD NO 197 VASANTHAPURA,Vijay Kumar A 9739163616,BR - 000135 / 30-Jun-2014CBR - 001953 / 06-Jun-2016Rtgs - 000049 / 09-Jun-2016,417350,363695,53655
11945,197-13-000090,Improvements to Main Roads and cross roads drains in Vajapayee Nagara in ward no 197,KRIDL9986096015,BR - 000136 / 30-Jun-2014CBR - 001955 / 06-Jun-2016Rtgs - 000049 / 09-Jun-2016,2190760,1836235,354525
11947,197-14-000048,Drilling of borewells electrification and pipeline etc at Maruthi layout Doddakallasandra Chikkalasandra Manjunath nagara and VV Nagar in ward no 197,KRIDL9986096015,BR - 000137 / 30-Jun-2014CBR - 001956 / 06-Jun-2016Rtgs - 000049 / 09-Jun-2016,3299040,2819305,479735
11791,197-14-000012,IMPROVEMENTS TO ROADS OF VV NAGARA 2ND BLOCK IN WARD NO 197 VASANTHAPURA,B S Shivakumar9845750001,BR - 000208 / 31-Jul-2014CBR - 002824 / 20-Jun-2016Rtgs - 000066 / 23-Jun-2016,891300,770250,121050
8819,197-11-000079,PROVIDING UGD SYSTEM TO VASANTHA VALLABHA NAGARA IN WARD NO. 197,KRIDL9880335511,BR - 000492 / 23-Jan-2014CBR - 003045 / 22-Jun-2016Rtgs - 000071 / 02-Jul-2016,447880,376590,71290
5116,197-14-000058,Improvements to roads and UGD to narayana nagara high tension line road in ward no 197 vasanthapura,KRIDL9845511104,BR - 000102 / 30-Jun-2014CBR - 003296 / 24-Jun-2016Rtgs - 000073 / 02-Jul-2016,4025076,3391421,633655
11641,197-14-000008,CONSTRUCTION OF CULVERTS AND SSM DRAIN AT GJ INDUSTRIAL AREA (KONANAKUNTE CROSS) IN WARD NO 197 VASANTHAPURA,H J Gopi9742767709,BR - 000234 / 30-Aug-2014CBR - 003522 / 30-Jun-2016Rtgs - 000078 / 12-Jul-2016,1571582,1347432,224150
9198,197-14-000031,IMPROVEMENT TO MAIN ROAD OF CHIKKALLASANDRA AK COLONY IN WARD NO 197 VASANTHAPURA,KRIDL9986096015,BR - 000247 / 30-Aug-2014CBR - 003527 / 30-Jun-2016Rtgs - 000078 / 12-Jul-2016,3275485,2755355,520130
11948,197-14-000049,Asphalting to cross roads of Bright way layout in ward no 197 Vasanthapura,KRIDL9986096015,BR - 000251 / 30-Aug-2014CBR - 003528 / 30-Jun-2016Rtgs - 000078 / 12-Jul-2016,2141260,1795315,345945
11950,197-14-000067,Improvements to drain and providing covering slab to main and cross roads of Canara Bank colony in ward no 197,KRIDL9986096015,BR - 000253 / 30-Aug-2014CBR - 003529 / 30-Jun-2016Rtgs - 000078 / 12-Jul-2016,4983660,4195670,787990
11174,197-14-000056,Improvements to drains at Sarvobhomanagara in ward no 197 vasanthapura,KRIDL9986096015,BR - 000254 / 30-Aug-2014CBR - 003531 / 30-Jun-2016Rtgs - 000078 / 12-Jul-2016,4887157,4112332,774825
11934,197-13-000023,Providing Cement Concrete Pavement Patchs to Damaged Concrete Roads in ward no 197,Narasimha Swamy9986096015,BR - 000256 / 30-Aug-2014CBR - 003532 / 30-Jun-2016Rtgs - 000078 / 12-Jul-2016,889410,758725,130685
11935,197-14-000009,IMPROVEMENTS AND ASPHALTNG THE KUVEMPU NAGARA GOKULAM APARTMENT ROAD IN WARD NO 197 VASANTHAPURA,Narashimha Swamy9986096015,BR - 000257 / 30-Aug-2014CBR - 003661 / 13-Jul-2016Rtgs - 000082 / 20-Jul-2016,2092740,1795595,297145
11939,197-14-000011,IMPROVEMENTS TO ROADS AND DRAINS AT ANJANADRI LAYOUT IN WARD NO 197 VASANTHAPURA,Narasimha Swamy9986096015,BR - 000258 / 30-Aug-2014CBR - 003662 / 13-Jul-2016Rtgs - 000082 / 20-Jul-2016,1038100,890640,147460
11926,197-13-000027,Missed Links of Water Supply Lines and Providing New lines in ward no 197,Vijay Kumar A 9986096015,BR - 000259 / 30-Aug-2014CBR - 003663 / 13-Jul-2016Rtgs - 000082 / 20-Jul-2016,463000,406485,56515
11927,197-13-000030,Improvements to Roads and Providing UGD Lines and repairs at Venkat school road in ward no 197,Vijay Kumar A 9986096015,BR - 000260 / 30-Aug-2014CBR - 003664 / 13-Jul-2016Rtgs - 000082 / 20-Jul-2016,477030,419200,57830
11930,197-14-000005,ASPHALTING AND IMPROVEMENTS TO ROADS AND DRAINS IN VITTALA NAGARA IN WARD NO 197 VASANTHAPURA,Vijay Kumar A 9986096015,BR - 000261 / 30-Aug-2014CBR - 003665 / 13-Jul-2016Rtgs - 000082 / 20-Jul-2016,2687350,2311110,376240
11931,197-14-000007,ASPHALTING AND IMPROVEMENTS TO ROADS AND DRAINS IN SIMHA LAYOUT IN WARD NO 197 VASANTHAPURA,Vijay Kumar A 9986096015,BR - 000262 / 30-Aug-2014CBR - 003671 / 13-Jul-2016Rtgs - 000082 / 20-Jul-2016,1044200,896120,148080
11940,197-14-000013,IMPROVEMENTS TO MAIN ROADS AND CROSS ROADS AT SNEHA COLONY IN WARD NO 197 VASANTHAPURA,Narasimha Swamy9986096015,BR - 000263 / 30-Aug-2014CBR - 003672 / 13-Jul-2016Rtgs - 000082 / 20-Jul-2016,1571375,1347390,223985
28746,197-16-000029,Improvements and providing covering slabs to drains at Bikasipura in Ward 197. ,KRIDL9886827056,BR - 000020 / 31-May-2016CBR - 003923 / 22-Jul-2016Rtgs - 000085 / 26-Jul-2016,2981440,2513140,468300
14027,197-11-000080,CONSTRUCTION OF LIBRARY BUILDING AND YOGA MANDIRA IN RAMANJANEYA LAYOUT IN WARD NO. 197,V Parappa9880226415,BR - 000368 / 29-Nov-2014CBR - 003920 / 22-Jul-2016Rtgs - 000087 / 29-Jul-2016,3116740,2676590,440150
18367,197-14-000051,Improvements to park and other development works in Maruthi nagara in ward no 197,KRIDL9999999999,BR - 000007 / 28-Oct-2015CBR - 004326 / 05-Aug-2016Rtgs - 000094 / 09-Aug-2016,2748337,2384102,364235
36472,197-16-000028,Development and improvements to roads and drains in main road and cross roads of ward No 197 Vasanthapura,KRIDL9986096015,BR - 000061 / 20-Jul-2016CBR - 004605 / 18-Aug-2016Rtgs - 000106 / 23-Aug-2016,9975050,8410405,1564645
44123,197-16-000027,Developmental works for providing Drinking water facility in Vasanthpura Ward No 197,KRIDL9986096015,BR - 000093 / 30-Jul-2016CBR - 005519 / 29-Sep-2016Rtgs - 000125 / 01-Oct-2016,9979830,8522530,1457300
46693,197-16-000030,Development of New Park ( Pakshi Vana) in Ward No 197 Vasanthpura ward.,KRIDL9999999999,BR - 000016 / 29-Jul-2016CBR - 005561 / 05-Oct-2016Rtgs - 000126 / 05-Oct-2016,2994926,2608546,386380
7536,197-15-000004,PROVIDING AND LAYING EXTENDING OF 300 MM DIADI WATER SUPPLY FEEDER LINE FORM KEB QUARTERS TO MARUTHI LAYOUT ON SUBRAMANYAPURA MAIN ROAD TO IMPROVE WATER SUPPLY FACILITIES TO MARUTHI LAYOUT BDA 5TH STAGE AND ITS SORROUNDING AREAS COMING UNDER KUMARASWAMY LAYOUT S S OF AEE S1 SUB DIVISION (DEPOSIT CONTRIBUTION TO BWSSB),BWSSB Deposit 1234567890,BR - 000232 / 18-Aug-2014CBR - 005491 / 29-Sep-2016Rtgs - 000146 / 25-Nov-2016,4960000,4960000,0
51466,197-16-000018,Improvements to roads from Kanakapura main road (H T Line) to Narayanagara 3rd Block in Ward No 197,VINOD KUMAR B K8884572139,BR - 0206/1 / 03-Nov-2016CBR - 005830 / 22-Nov-2016Rtgs - 000148 / 28-Nov-2016,9082650,7787350,1295300
51469,197-16-000019,Improvements to roads from Narayananagara 3rd block to PNB layout in ward No 197,VINOD KUMAR B K8884572139,BR - 0206/2 / 03-Nov-2016CBR - 005831 / 22-Nov-2016Rtgs - 000148 / 28-Nov-2016,6779110,5811920,967190
51470,197-16-000022,Improvements to roads and drains from Shanthisagara to Chikkallasandra,VINOD KUMAR B K8884572139,BR - 0206/3 / 03-Nov-2016CBR - 005832 / 22-Nov-2016Rtgs - 000148 / 28-Nov-2016,9032525,7743755,1288770
14658,197-14-000063,Sinking of borewell of 165mm dia and providing electrification pipe lline in ward no 197 vasanthapura,KRIDL9986096015,BR - 000377 / 29-Nov-2014CBR - 006244 / 24-Dec-2016Rtgs - 000161 / 28-Dec-2016,2143125,1819995,323130
10803,197-14-000030,PROVIDING CEMENT CONCRETE PAVEMENT ROAD AT VASANTHAPURA AK COLONY ANNAMMA ROAD IN WARD NO 197 VASANTHAPURA,KRIDL9986096015,BR - 000378 / 29-Nov-2014CBR - 006256 / 26-Dec-2016Rtgs - 000161 / 28-Dec-2016,3049464,2557395,492069
10804,197-14-000028,IMPROVEMENTS TO UGD DRAINS AND PROVIDING CC ROAD FROM POST OFFICE TO DODDAKALLASANDRA AK COLONY IN WARD NO 197,KRIDL9986096015,BR - 000379 / 29-Nov-2014CBR - 006257 / 26-Dec-2016Rtgs - 000161 / 28-Dec-2016,2740990,2297480,443510
14661,197-13-000086,Improvements and Asphalting to the roads at B I P school road Manjunathanagara and Canara Bank Colony in ward no 197,KRIDL9986096015,BR - 000380 / 29-Nov-2014CBR - 006259 / 26-Dec-2016Rtgs - 000161 / 28-Dec-2016,4354355,3576112,778243
14655,197-14-000022,PROVIDING CC PATCHES TO DAMAGED CONCRETE ROADS IN CANARA BANK CROSS ROADS AT KONANAKUNTE IN WARD NO 197 VASANTHAPURA,Narasimha Swamhy9986096015,BR - 000381 / 29-Nov-2014CBR - 006260 / 26-Dec-2016Rtgs - 000161 / 28-Dec-2016,980535,842780,137755
14657,197-14-000025,EMERGENCY WORKS IN WARD NO 197 VASANTHAPURA,Narasimha swamy9986096015,BR - 000382 / 29-Nov-2014CBR - 006262 / 26-Dec-2016Rtgs - 000161 / 28-Dec-2016,507200,444445,62755
14656,197-14-000014,PROVIDING LABOUR AND TRACTOR FOR CLEARING THE DEBRIS ON FOOT PATH AND DRAINS IN WARD NO 197 VASANTHAPURA,Narasimhaswamy9986096015,BR - 000383 / 29-Nov-2014CBR - 006263 / 26-Dec-2016Rtgs - 000161 / 28-Dec-2016,1040965,906078,134887
14659,197-14-000016,IMPROVEMENTS TO DRAINS AND RESETTING OF DAMAGED DRAIN IN WARD NO 197 VASANTHAPURA,Vijay Kumar A 9986096015,BR - 000384 / 29-Nov-2014CBR - 006264 / 26-Dec-2016Rtgs - 000161 / 28-Dec-2016,1038480,893045,145435
15598,197-14-000033,PROVIDING DRINKING WATER THORUGH WATER TANKERS IN WARD NO 197 VASANTHAPURA,A Vijay Kumar9986096015,BR - 000385 / 29-Nov-2014CBR - 006266 / 26-Dec-2016Rtgs - 000161 / 28-Dec-2016,509124,447249,61875
14660,197-14-000034,PROVIDING MATERIALS LIKE CABLE PUMP AND MOTOR GI PIPES TO EXISTING BOREWELLS IN WARD NO 197 VASANTHAPURA,A Vijay Kumar9986096015,BR - 000386 / 29-Nov-2014CBR - 006267 / 26-Dec-2016Rtgs - 000161 / 28-Dec-2016,1021180,893965,127215
15624,197-14-000035,DRILLING OF 165MM DIA BOREWELLS IN WARD NO 197 VASANTHAPURA,Vijay Kumar A 9986096015,BR - 000387 / 29-Nov-2014CBR - 006268 / 26-Dec-2016Rtgs - 000161 / 28-Dec-2016,982706,860211,122495
15622,197-14-000032,ANNUAL MAINTENANCE OF WATER SUPPLY IN WARD NO 197 VASANTHAPURA,Vijay Kumar A9986096015,BR - 000388 / 29-Nov-2014CBR - 006270 / 26-Dec-2016Rtgs - 000161 / 28-Dec-2016,762380,665930,96450
15599,197-14-000015,ANNUAL MAINTENANCE OF UGD IN WARD NO 197 VASANTHAPURA,Vijay Kumar A9986096015,BR - 000389 / 29-Nov-2014CBR - 006271 / 26-Dec-2016Rtgs - 000161 / 28-Dec-2016,1241310,1082020,159290
15597,197-14-000068,Improvements to drain and providing covering slab to main and cross roads of Sarvabhomanagara in ward no 197,KRIDL9986096015,BR - 000395 / 29-Nov-2014CBR - 006276 / 26-Dec-2016Rtgs - 000161 / 28-Dec-2016,4985500,4194850,790650
15627,197-14-000010,POT HOLE FILLING AT CHIKKALLASANDRA SARVABHOMA NAGARA RAMANJANEYA NAGARA AND SURROUNDING AREAS IN WARD NO 197 VASANTHAPURA,Narasimha Swamy9986096015,BR - 000396 / 29-Nov-2014CBR - 006277 / 26-Dec-2016Rtgs - 000161 / 28-Dec-2016,1046938,899838,147100
10805,197-14-000027,IMPROVEMENTS TO ROADS AND DRAINS AT KONANAKUNTE AK COLONY IN WARD NO 197,KRIDL9986096015,BR - 000442 / 30-Dec-2014CBR - 006806 / 18-Jan-2017Rtgs - 000174 / 21-Jan-2017,3294950,2760880,534070
15294,197-14-000023,PROVIDING UGD WATER LINE AND IMPROVEMENTS TO ROAD AT MUNIREDDY COMPOUND NEAR SHRAVANTHI KALYANA MANTAPA IN WARD NO 197 VASANTHAPURA,Vijay Kumar A 9986096015,BR - 000443 / 30-Dec-2014CBR - 006807 / 18-Jan-2017Rtgs - 000174 / 21-Jan-2017,2021670,1728615,293055
14662,197-14-000064,Providing asphalting and cc pavements in siddanna layout and vallabha nagara in ward no 197 vasanthapura,KRIDL9986096015,BR - 000537 / 30-Mar-2015CBR - 008427 / 25-Mar-2017Rtgs - 000226 / 28-Mar-2017,4853024,4054229,798795
14840,197-14-000029,DRILLING OF NEW BOREWELL MATERIALS ELECTRIFICATION AT DODDAKALLASANDRA AK COLONY AYYAPPA NAGARA VASANTHAPURA AK COLONY IN WARD NO 197,KRIDL9986096015,BR - 000538 / 31-Mar-2015CBR - 008434 / 25-Mar-2017Rtgs - 000226 / 28-Mar-2017,3133845,2661290,472555
15293,197-14-000017,IMPROVEMENTS AND PROVIDING CC PAVEMENT TO SARVABHOMA NAGARA (MUNIYAMMA LAYOUT) CROSS ROADS IN WARD NO 197 VASANTHAPURA,Vijay kumar A9986096015,BR - 000539 / 31-Mar-2015CBR - 008435 / 25-Mar-2017Rtgs - 000226 / 28-Mar-2017,1001990,851140,150850
15621,197-15-000042,Improvements to raods and drains at Nisarga Layout in ward No 197 ,KRIDL9986096015,BR - 000540 / 31-Mar-2015CBR - 008436 / 25-Mar-2017Rtgs - 000226 / 28-Mar-2017,1950380,1641270,309110
15292,197-15-000028,Asphalting to roads at Munireddy compound near Shravanthi Kalyana Mantapa in ward No.197,KRIDL9986096015,BR - 000542 / 31-Mar-2015CBR - 008437 / 25-Mar-2017Rtgs - 000226 / 28-Mar-2017,1980580,1667390,313190
15295,197-14-000021,CONSTRUCTION OF CULVERTS AND REPAIRS TO EXISTING CULVERTS AND SSM DRAIN IN WARD NO 197 VASANTHAPURA,Narasimha Swamy9986096015,BR - 000541 / 31-Mar-2015CBR - 008492 / 26-Mar-2017Rtgs - 000226 / 28-Mar-2017,1036700,878425,158275
77602,197-16-000020,Improvements to roads from Abbaiah naidu studio to Ramanjeneya nagara in Ward NO 197,vinod kumar b k9900162862,BR - 00288A / 23-Mar-2017CBR - 000261 / 13-Apr-2017Rtgs - 000012 / 17-Apr-2017,6037000,5604550,432450
77593,197-16-000021,Improvements to roads and drains from Kanakapura road to Vasanthapura temple,vinod kumar b k9900162862,BR - 00288C / 23-Mar-2017CBR - 000262 / 13-Apr-2017Rtgs - 000012 / 17-Apr-2017,13398000,12538800,859200
77597,197-16-000017,Improvements to roads from Kanakapura main road via Uma maheshwari temple to Narayana nagara double road in Ward No 197,vinod kumar b k9900162862,BR - 00288B / 23-Mar-2017CBR - 000263 / 13-Apr-2017Rtgs - 000012 / 17-Apr-2017,5184000,4811950,372050
58299,197-15-000007,Improvements to drains and construction of CC drain Behind Sneha colony in ward no 197 Vasanthapura,MOHAN L9980489228,BR - 000006 / 30-Apr-2015CBR - 001168 / 04-May-2017Rtgs - 000046 / 05-May-2017,1912460,1647420,265040
52998,197-15-000008,Asphalting the road from Sarvabhoma nagara 6th cross to Sri Rama circle in ward no 197 Vasanthapura,UDAY KUMAR K 9845131166,BR - 000046 / 29-May-2015CBR - 001270 / 06-May-2017Rtgs - 000052 / 10-May-2017,1967520,1688740,278780
55433,197-15-000010,Improvements and asphalting the main roads at Sarvabhomangara in ward no 197 Vasanthapura,UDAY KUMAR K9845166366,BR - 000047 / 29-May-2015CBR - 001271 / 06-May-2017Rtgs - 000052 / 10-May-2017,4442320,3812585,629735
53001,197-15-000009,Improvements and asphalting the cross roads at Ramanjaneya nagara in ward no 197 vasanthapura,uday kumar k 9845131166,BR - 000048 / 29-May-2015CBR - 001272 / 06-May-2017Rtgs - 000052 / 10-May-2017,1928910,1655175,273735
81792,197-15-000029,Improvements to roads and drains from Alpine school to Mango garden in ward No.197,KRIDL9986096015,BR - 000027 / 30-Apr-2015CBR - 001360 / 08-May-2017Rtgs - 000052 / 10-May-2017,1974990,1646860,328130
57737,197-15-000013,Improvements to drains and construction of culverts at Canara bank colony near Gandhi park in ward no 197 vasanthapura,MOHAN L 9980489228,BR - 000054 / 30-May-2015CBR - 001362 / 08-May-2017Rtgs - 000052 / 10-May-2017,872330,756800,115530
81693,197-15-000005,Improvements and Asphalting the main roads of KSRTC Layout in ward no 197 vasanthapura,S SATISH9901333577,BR - 000038 / 30-Apr-2015CBR - 001810 / 18-May-2017Rtgs - 000066 / 23-May-2017,3585670,3082470,503200
59091,197-15-000011,Asphalting the main and cross roads of Vaipayee nagara in ward no 197 Vasanthapura,uday kumar k9845632017,BR - 000045 / 29-May-2015CBR - 001811 / 18-May-2017Rtgs - 000066 / 23-May-2017,3153745,2706475,447270
84948,197-14-000033,PROVIDING DRINKING WATER THORUGH WATER TANKERS IN WARD NO 197 VASANTHAPURA,A Vijay Kumar9986096015,BR - 000031 / 30-Apr-2015CBR - 001890 / 19-May-2017Rtgs - 000066 / 23-May-2017,519650,456470,63180
84940,197-15-000030,Asphalting to balance roads of bright way layout in ward No.197,KRIDL9986096015,BR - 000033 / 30-Apr-2015CBR - 001891 / 19-May-2017Rtgs - 000066 / 23-May-2017,1981000,1631970,349030
84945,197-15-000046,Improvments to drains providing covering slabs and kerb stones to Chikkallasandra main road in ward No 197. ,KRIDL9986096015,BR - 000026 / 30-Apr-2015CBR - 002378 / 30-May-2017Rtgs - 000084 / 01-Jun-2017,1932610,1607620,324990
2672,197-15-000020,Pot Hole Filling at Kuvempu nagara Doddakallasandra konanakunte PNB layout and doctors layout in Vasanthapura ward no 197,Mukundareddy G 9845067855,BR - 000094 / 30-Jul-2015CBR - 002379 / 30-May-2017Rtgs - 000084 / 01-Jun-2017,989740,859110,130630
93574,197-17-000001,Development and Improvements to drain and roads at TATA showroom and Siri Daba Doddakalsandra in ward no 197,KRIDL9886631704,BR - 000015 / 28-Apr-2017CBR - 003708 / 10-Jul-2017Rtgs - 000134 / 12-Jul-2017,9983020,8335660,1647360
94655,197-15-000049,"Construction of RCC U Shape Drain for SWD RN-217 at Vittala Nagara 1st stage, 1st main in Vasanthapura ward no.197 of Bommanahalli Zone ",T.T.Venkataramana Reddy9663311666,BR - 000037 / 20-Jun-2017CBR - 004015 / 18-Jul-2017Rtgs - 000148 / 20-Jul-2017,9910300,9250250,660050
41066,197-16-000007,Construction of purified drinking water plant in ward no 197 vasanthapura,Boregowda H B9900155965,BR - 000079 / 30-Jul-2016CBR - 004033 / 20-Jul-2017Rtgs - 000155 / 25-Jul-2017,2555620,2197569,358051
41060,197-16-000005,Annual maintainance of UGD system in ward no 197 Vasanthapura,Boregowda H B9900155965,BR - 000082 / 30-Jul-2016CBR - 004034 / 20-Jul-2017Rtgs - 000155 / 25-Jul-2017,1680940,1459490,221450
41125,197-16-000004,Annual maintainance of water supply system in ward no 197 Vasanthapura,Boregowda H B9900155965,BR - 000081 / 30-Jul-2016CBR - 004035 / 20-Jul-2017Rtgs - 000155 / 25-Jul-2017,1537800,1343250,194550
80167,197-16-000047,Improvements to roads and drains at SC colony in ward no 197 Vasanthapura,Manupathi murali9535051863,BR - 000284 / 09-Mar-2017CBR - 004937 / 22-Aug-2017Rtgs - 000194 / 23-Aug-2017,904360,788930,115430
82921,197-14-000032,ANNUAL MAINTENANCE OF WATER SUPPLY IN WARD NO 197 VASANTHAPURA,Vijay Kumar A9986096015,BR - 000028 / 30-Apr-2015CBR - 005508 / 06-Sep-2017Rtgs - 000210 / 07-Sep-2017,1256900,1104140,152760
88373,197-15-000021,Providing Tractor and labour for maintenance in wad no197,NARASIMHA SWAMY9986096015,BR - 000135 / 30-Sep-2015CBR - 005514 / 06-Sep-2017Rtgs - 000210 / 07-Sep-2017,1022400,897800,124600
7690,197-15-000003,Improvements and asphalting the 22nd cross road and service road at narayana nagara (Near Kanakapura main road) in ward no 197 vasanthapura,B S Ramesh9743076746,BR - 000189 / 30-Dec-2015CBR - 005566 / 06-Sep-2017Rtgs - 000210 / 07-Sep-2017,4912220,4240010,672210
7057,197-14-000041,"improvements and asphalting the kalyani nagar,devara kere,bright way school via lakshamma and bhadramma home road in ward no 197 ",KRIDL9900007121,BR - 000204 / 30-Jan-2016CBR - 005599 / 07-Sep-2017Rtgs - 000210 / 07-Sep-2017,2997214,2510064,487150
88238,197-15-000024,Improvements to Drains and Providing covering slab to Sneha colony in ward no 197,kridl9986096015,BR - 000125 / 10-Sep-2015CBR - 005963 / 16-Sep-2017Rtgs - 000225 / 20-Sep-2017,3418000,2847070,570930
88192,197-15-000033,Pothole filling to roads at Doddakalasandra Chikkalasandra and surrounding areas in ward no 197,KRIDL9986096015,BR - 000122 / 10-Sep-2015CBR - 006068 / 21-Sep-2017Rtgs - 000232 / 22-Sep-2017,998300,842520,155780
88209,197-15-000032,Improvements to drains and providing covering slabs to 4th 5th 6th and 7th main Sarvabhomanagara in ward no 197,KRIDL9986096015,BR - 000139 / 30-Sep-2015CBR - 006070 / 21-Sep-2017Rtgs - 000232 / 22-Sep-2017,4997000,4162500,834500
88387,197-15-000031,"Improvements to drains and providing culverts at Vajapayee Nagar, Sarvabhomanagar, Udaynagar surroundings areas in ward No.197",KRIDL9986096015,BR - 000116 / 10-Sep-2015CBR - 006213 / 22-Sep-2017Rtgs - 000232 / 22-Sep-2017,3904000,3242110,661890
88269,197-15-000043,Improvements to roads and drains at Sumukha layout and slate Factory road in ward NoL 197. ,kridl9986096015,BR - 000119 / 10-Sep-2015CBR - 006218 / 22-Sep-2017Rtgs - 000232 / 22-Sep-2017,3926000,3249540,676460
88240,197-15-000026,Improvements to Drains and Providing covering slab to balance roads of canara bank colony in ward no 197,KRIDL9986096015,BR - 000131 / 30-Sep-2015CBR - 006219 / 22-Sep-2017Rtgs - 000232 / 22-Sep-2017,4980000,4143120,836880
88435,197-15-000023,Providing CC patchs to dameged concrete road in ward no 197,Narasimha swamy9986096015,BR - 000132 / 30-Sep-2015CBR - 006221 / 22-Sep-2017Rtgs - 000232 / 22-Sep-2017,990000,845500,144500
98196,197-16-000001,Annual Operation and Maintenance of street lighting system in ward no-197 Package B14 of Bommanahalli zone.,M/s Sri Venkateswara Electricals9945811466,BR - 000021 / 15-Jul-2017CBR - 006339 / 25-Sep-2017Rtgs - 000236 / 27-Sep-2017,800733,680183,120550
5254,197-14-000001,PROVIDING UGD AND CC PAVEMENT TO CROSS ROADS AT CANARA BANK ROAD AND 8TH CROSS SIDDANNA LAYOUT IN WARD NO 197 VASANTHAPURA,B S Shivakumar9945751538,BR - 000168 / 16-Nov-2015CBR - 006665 / 10-Oct-2017Rtgs - 000247 / 12-Oct-2017,1449000,1246380,202620
78118,197-16-000048,Improvements to roads and drains at ST colony in ward no 197 Vasanthapura,SURESH B N9620350580,BR - 000297 / 31-Mar-2017CBR - 006871 / 24-Oct-2017Rtgs - 000259 / 25-Oct-2017,519600,451980,67620
53717,197-14-000053,Providing electrical lighting to devarakere in ward no 197 Vasanthapura,M/s Technical Manager- 01 KRIDL1971400005,BR - 000173 / 11-May-2016CBR - 007094 / 28-Oct-2017Rtgs - 000266 / 30-Oct-2017,1069288,893093,176195
53716,197-14-000054,Providing electrical lighting to parks at Narayana nagara Maruthi layout and Ramanjaneya nagara in ward no 197 Vasanthapura,M/s Technical Manager- 01 KRIDL1971400005,BR - 000172 / 11-May-2016CBR - 007095 / 28-Oct-2017Rtgs - 000266 / 30-Oct-2017,1113152,933732,179420
53712,197-14-000055,Providing street light at Ward No.197 ,M/s Technical Manager- 01 KRIDL1971400005,BR - 000174 / 24-May-2016CBR - 007096 / 28-Oct-2017Rtgs - 000266 / 30-Oct-2017,4817862,4082742,735120
119399,197-17-000043,Providing and fixing of LED Street lights in Ward No 197 in Bangalore South Division,M/s. Sri Venkateswara Electrical9945811466,BR - 000041 / 30-Oct-2017CBR - 007823 / 14-Nov-2017Rtgs - 000287 / 16-Nov-2017,1240800,1093125,147675
110563,197-17-000048,Improvements to Roads and drains of main road siddanna layout in ward no 197 vasanthapura,KRIDL8884572139,BR - 000178 / 30-Jun-2017CBR - 007932 / 15-Nov-2017Rtgs - 000288 / 16-Nov-2017,1999900,1667920,331980
110535,197-17-000046,Improvements and Asphalting the main road and 1st and 2nd cross road of BSK 5th stage vasanthapura in ward no 197 vasanthapura,KRIDL8884572139,BR - 000176 / 30-Jun-2017CBR - 007934 / 15-Nov-2017Rtgs - 000288 / 16-Nov-2017,2998800,2500950,497850
86573,197-14-000015,ANNUAL MAINTENANCE OF UGD IN WARD NO 197 VASANTHAPURA,Vijay Kumar A9986096015,BR - 000029 / 30-Apr-2015CBR - 007849 / 14-Nov-2017Rtgs - 000291 / 17-Nov-2017,817150,698290,118860
82904,197-14-000019,POT HOLE FILLING AT VV NAGARA PRASHANTHI NAGARA VITTALLA NAGARA KUVEMPU NAGARA AND SURROUNDING AREAS IN WARD NO 197 VASANTHAPURA,vijay kumar a9986096015,BR - 000030 / 30-Apr-2015CBR - 007850 / 14-Nov-2017Rtgs - 000291 / 17-Nov-2017,1035400,871620,163780
88215,197-15-000036,Missed links of UGD and PVC GI Pipelines in ward no 197,KRIDL9986096015,BR - 000124 / 10-Sep-2015CBR - 007851 / 14-Nov-2017Rtgs - 000291 / 17-Nov-2017,998000,838770,159230
88270,197-15-000047,Asphalting to roads and Improvments of drains at Simha layout and doctors layout in ward No 197,KRIDL9986096015,BR - 000117 / 10-Sep-2015CBR - 007855 / 14-Nov-2017Rtgs - 000291 / 17-Nov-2017,965000,799500,165500
86587,197-15-000016,Providing UGD line at Kuvempu nagara cross roads in ward no 197 Vasanthapura,narasimha swamy9986096015,BR - 000032 / 30-Apr-2015CBR - 007870 / 14-Nov-2017Rtgs - 000291 / 17-Nov-2017,507000,442060,64940
88368,197-15-000044,Asphalting to roads and improvments to drains at RamanyaneyaNagara Bus stop and surrounding areas in ward No 197 ,KRIDL9986096015,BR - 000118 / 10-Sep-2015CBR - 007871 / 14-Nov-2017Rtgs - 000291 / 17-Nov-2017,2996400,2494680,501720
88431,197-15-000048,Asphalting to balance main and cross roads of KSRTC layout in ward No 197 ,kridl9986096015,BR - 000120 / 10-Sep-2015CBR - 007872 / 14-Nov-2017Rtgs - 000291 / 17-Nov-2017,2970800,2473500,497300
88426,197-14-000024,IMPROVEMENTS TO DRAINS AT GANAPATHIPURA CROSS ROADS IN WARD NO 197 VASANTHAPURA,a vijay kumar 9986096015,BR - 000126 / 10-Sep-2015CBR - 007873 / 14-Nov-2017Rtgs - 000291 / 17-Nov-2017,278000,239950,38050
110311,197-17-000005,Potholes filling at Chikkalasandra in ward no 197 Vasanthapura,"M/s Srusti Infrastructure, Proop. Sri.A.Vijay Kumar9986096015",BR - 000141 / 30-Jun-2017CBR - 007916 / 15-Nov-2017Rtgs - 000293 / 17-Nov-2017,1959000,1652040,306960
110309,197-17-000050,Improvements to roads and darins from kanakapura main road (sharvanthi kalyana matapa) to kumaran school road doddakalsandra in ward 197 vasanthapura,KRIDL9986096015,BR - 000142 / 30-Jun-2017CBR - 008067 / 21-Nov-2017Rtgs - 000297 / 23-Nov-2017,1999000,1664000,335000
110572,197-17-000049,Improvements to Drain and roads of V V Nagara 1st main road in 1st block in ward no 197 vasanthapura,KRIDL8884572139,BR - 000177 / 30-Jun-2017CBR - 008093 / 22-Nov-2017Rtgs - 000297 / 23-Nov-2017,1999700,1666720,332980
110555,197-17-000045,Improvements and Asphalting the 4th main 5th cross and 3rd F cross maruthi layout in ward no 197 vasanthapura,KRIDL8884572139,BR - 000179 / 30-Jun-2017CBR - 008094 / 22-Nov-2017Rtgs - 000297 / 23-Nov-2017,2999500,2499530,499970
88380,197-15-000015,Improvements and providing cement concrete roads at vittal nagara 2nd block in ward no197 Vasanthapura,NARASIMHA SWAMY9986096015,BR - 000121 / 10-Sep-2015CBR - 008017 / 20-Nov-2017Rtgs - 000298 / 23-Nov-2017,711100,613670,97430
88264,197-15-000022,Annual Maintenance of Water supply in ward no 197,Mr VIJAYAKUMAR A 9986096015,BR - 000134 / 30-Sep-2015CBR - 008371 / 06-Dec-2017Rtgs - 000324 / 11-Dec-2017,1393900,1217860,176040
88185,197-15-000035,"Drilling New borewells Providing motors electrical works pipeline etc,. in ward no 197",KRIDL9986096015,BR - 000123 / 10-Sep-2015CBR - 008377 / 06-Dec-2017Rtgs - 000324 / 11-Dec-2017,1963000,1675220,287780
88260,197-15-000045,"Improvements to drains, culverts desalting of drains near Komarala feeds, MuniyammaThota, Ramanjaneyanagara, Chikkallasandraand surrounding areas in ward No 197 ",KRIDL9986096015,BR - 000138 / 30-Sep-2015CBR - 008378 / 06-Dec-2017Rtgs - 000324 / 11-Dec-2017,1997000,1650300,346700
88365,197-15-000017,Missed links of UGD system in ward no 197 vasanthapura,A VIJAY KUMAR9986096015,BR - 000136 / 30-Sep-2015CBR - 008380 / 06-Dec-2017Rtgs - 000324 / 11-Dec-2017,989000,855210,133790
56592,197-16-000025,IMPROVEMENTS TO PARKS AT RAMANJANEYA NAGARA IN WARD NO 197 VASANTHAPURA,KRIDL9999999999,BR - 000010 / 29-Jul-2016CBR - 008416 / 11-Dec-2017Rtgs - 000329 / 16-Dec-2017,2999019,2631594,367425
56611,197-16-000024,IMPROVEMENTS TO PARKS AT NARAYANA NAGARA IN WARD NO 197 VASANTHAPURA,KRIDL9999999999,BR - 000011 / 29-Jul-2016CBR - 008417 / 11-Dec-2017Rtgs - 000329 / 16-Dec-2017,3982419,3495464,486955
56581,197-16-000026,IMPROVEMENTS TO PARKS AT DEVARA KERE IN WARD NO 197 VASANTHAPURA,KRIDL9999999999,BR - 000012 / 29-Jul-2016CBR - 008418 / 11-Dec-2017Rtgs - 000329 / 16-Dec-2017,2989825,2623568,366257
56572,197-16-000023,PROVIDING CHILDERN PALY EQUIPMENTS AND OTHER DEVELOPMENTAL WORKS AT DEVARAKERE PARK IN WARD NO 197 VASANTHA PURA,KRIDL9999999999,BR - 000013 / 29-Jul-2016CBR - 008419 / 11-Dec-2017Rtgs - 000329 / 16-Dec-2017,4907868,4301920,605948
56546,197-15-000052,Improvements to parks at Devara Kere in ward no 197,KRIDL9999999999,BR - 000007 / 28-Jul-2016CBR - 008428 / 11-Dec-2017Rtgs - 000329 / 16-Dec-2017,1476090,1291215,184875
56602,197-15-000051,Improvements to park at Narayana Nagara 1st Block in ward no 197,KRIDL9999999999,BR - 000009 / 28-Jul-2016CBR - 008429 / 11-Dec-2017Rtgs - 000329 / 16-Dec-2017,1651400,1435279,216121
34952,197-16-000003,Pot holes filling in ward no 197 Vasanthapura.,Manjunath K9845183166,BR - 000100 / 16-Aug-2016CBR - 008628 / 21-Dec-2017Rtgs - 000336 / 21-Dec-2017,1493650,1288280,205370
88197,197-15-000027,Improvements to Drains and Providing covering slab to balance roads of Sarvabhoma nagara in ward no 197,kridl9986096015,BR - 000137 / 30-Sep-2015CBR - 008465 / 12-Dec-2017Rtgs - 000339 / 22-Dec-2017,4998000,4158190,839810
1916,197-15-000014,Asphalting the 1st main road at Manjunath nagara in ward no 197 Vasanthapura,K Uday Kumar9845131166,BR - 000068 / 30-Jun-2015CBR - 008884 / 08-Jan-2018Rtgs - 000368 / 27-Jan-2018,1843330,1572590,270740
88262,197-15-000018,Annual Maintenance of UGD System in ward no 197,Mr VIJAYAKUMAR A 9986096015,BR - 000133 / 30-Sep-2015CBR - 008885 / 08-Jan-2018Rtgs - 000368 / 27-Jan-2018,1331000,1153220,177780
72556,197-16-000005,Annual maintainance of UGD system in ward no 197 Vasanthapura,Boregowda H B9900155965,BR - 000180 / 20-Sep-2016CBR - 009255 / 30-Jan-2018Rtgs - 000378 / 01-Feb-2018,403510,356000,47510
72550,197-16-000004,Annual maintainance of water supply system in ward no 197 Vasanthapura,Boregowda H B9900155965,BR - 000181 / 20-Sep-2016CBR - 009256 / 30-Jan-2018Rtgs - 000378 / 01-Feb-2018,549780,431230,118550
144631,197-17-000038,"Improvements to drains and roads at Manga garden in 1st, 2nd, 3rd cross dead end road near delhi Public school in Ward no.197, Vasanthapura",Sri B K Vinod Kumar9845222227,BR - 000089 / 27-Feb-2018CBR - 000059 / 01-Apr-2018Rtgs - 000001 / 04-Apr-2018,4468000,4239710,228290
144625,197-17-000039,"Improvements to drains and roads at Doctors colony 2nd main, 1st, 1st A , 2nd, 2nd A , 3rd, 4th, amd 5th cross at Doddakallasandra in Ward no.197 Vasanthapura",Sri B K Vinod Kumar9845222227,BR - 000092 / 28-Feb-2018CBR - 000062 / 01-Apr-2018Rtgs - 000001 / 04-Apr-2018,4468000,4239620,228380
144611,197-17-000040,Improvements to drains and roads at Soudhamini layout 2nd main from Amruthnagara main road to KEB in Ward no.197 Vasanthapura,Sri B K Vinod Kumar9845222227,BR - 000131 / 05-Mar-2018CBR - 000096 / 01-Apr-2018Rtgs - 000001 / 04-Apr-2018,1938300,1842150,96150
150851,197-17-000041,Construction of Culverts at Maruthi layout in Ward no.197 Vasanthapura,Sri B K Vinod Kumar9845222227,BR - 000146 / 15-Mar-2018CBR - 000327 / 06-Apr-2018Rtgs - 000007 / 06-Apr-2018,384000,370535,13465
150814,197-17-000055,Providing Modren Dust Bin in Bangalore City in ward no 197,Sri M Taiyub Ahemd9620350580,BR - 000147 / 15-Mar-2018CBR - 000423 / 09-Apr-2018Rtgs - 000013 / 10-Apr-2018,132910,121950,10960
53484,197-16-000006,Providing UGD lines and Missed Links in ward no 197 Vasanthapura,Boregowda H B9900155965,BR - 000080 / 30-Jul-2016CBR - 000528 / 13-Apr-2018Rtgs - 000023 / 24-Apr-2018,2953500,2547765,405735
43099,197-16-000033,Improvements and Construction of drains at uttarahalli vasanthapura Main road in ward o.197 Vasanthapura,B N SURESH9900197571,BR - 000115 / 23-Aug-2016CBR - 001416 / 16-May-2018Rtgs - 000052 / 18-May-2018,2373170,2046885,326285
55630,197-16-000038,Providing and asphalting to roads at 7th main and 11th Cross road in Narayananagara 3rd Block ward No 197,VIJAY KUMAR A9880545654,BR - 000128 / 30-Aug-2016CBR - 001697 / 22-May-2018Rtgs - 000067 / 31-May-2018,3298260,2816650,481610
55686,197-16-000032,"Improvements and Asphalting the roads at Maruthi layout in ward no.197, Vasanthapura",VIJAYA KUMAR A9880545654,BR - 000129 / 30-Aug-2016CBR - 001698 / 22-May-2018Rtgs - 000067 / 31-May-2018,2369240,2020990,348250
75583,197-16-000039,Improvements to Devarakere in Ward No 197 Vasanthapura,vijay kumar a9986096015,BR - 000144 / 12-Sep-2016CBR - 002123 / 02-Jun-2018Rtgs - 000071 / 06-Jun-2018,1398600,1205160,193440
55648,197-16-000034,"Improvements and Asphalting the balance roads at vittal nagara and Maruthi layout in ward no.197, Vasanthapura",VIJAY KUMAR A9880545654,BR - 000145 / 12-Sep-2016CBR - 002124 / 02-Jun-2018Rtgs - 000071 / 06-Jun-2018,2388960,2037750,351210
55643,197-16-000036,"Improvements and Asphalting the roads at Vallabha nagara in ward no.197, Vasanthapura",VIJAY KUMAR A9880545654,BR - 000147 / 12-Sep-2016CBR - 002125 / 02-Jun-2018Rtgs - 000071 / 06-Jun-2018,1914110,1632780,281330
55687,197-16-000040,Improvements and asphalting to PNB layout and Doctors colony in Ward No 197,VIJAYA KUMAR A9880545654,BR - 000148 / 12-Sep-2016CBR - 002126 / 02-Jun-2018Rtgs - 000071 / 06-Jun-2018,2858560,2440880,417680
108117,197-16-000010,Providing drinking water through water tankers in ward no 197 vasanthapura,C K Harish9480292727,BR - 000090 / 30-Jun-2017CBR - 002228 / 06-Jun-2018Rtgs - 000079 / 11-Jun-2018,984935,864535,120400
106279,197-17-000015,Drilling of 165 mm Dia New borewell and providing electrification and Distribution of pipe line in ward no.197 Vasanthapura,H B Boregowda9900155965,BR - 000097 / 30-Jun-2017CBR - 002229 / 06-Jun-2018Rtgs - 000079 / 11-Jun-2018,2902000,2532340,369660
106226,197-17-000008,Maintaince of Water Supply system in ward no.197 Vasanthapura,H B Boregowda9900155965,BR - 000099 / 30-Jun-2017CBR - 002231 / 06-Jun-2018Rtgs - 000079 / 11-Jun-2018,1022200,897170,125030
158943,197-17-000047,Improvements and Asphalting the main and 1st 2nd 3rd cross road of vittal nagara 1st stage in ward no 197 vasanthapura,M/s KRIDL9986096015,BR - 000006 / 25-Apr-2018CBR - 003149 / 29-Jun-2018Rtgs - 000105 / 02-Jul-2018,2998500,2622640,375860
108266,197-16-000035,"Improvements and Asphalting the roads at Narayana nagara in ward no.197, Vasanthapura",VIJAY KUMAR A9845222227,BR - 000143 / 12-Sep-2016CBR - 003499 / 10-Jul-2018Rtgs - 000125 / 16-Jul-2018,3828750,3301920,526830
137233,197-16-000001,Annual Operation and Maintenance of street lighting system in ward no-197 Package B14 of Bommanahalli zone.,M/s Sri Venkateswara Electricals9945811466,BR - 000062 / 24-Jan-2018CBR - 003915 / 18-Jul-2018Rtgs - 000134 / 20-Jul-2018,1410282,1223241,187041
162323,197-17-000056,Providing CC Camera at Garbage Block Spots in ward no 197,Sri M Taiyub Ahmed9845929841,BR - 000055 / 19-May-2018CBR - 004070 / 20-Jul-2018Rtgs - 000137 / 23-Jul-2018,882200,807550,74650
110207,197-15-000006,Improvements to roads and drains at anjaneya swamy temple road and Madduramma temple road near St Dominic School in ward no 197 Vasanthapura,Vijay Kumar A9986096015,BR - 000124 / 30-Aug-2016CBR - 004279 / 25-Jul-2018Rtgs - 000152 / 03-Aug-2018,1025500,870910,154590
108251,197-16-000037,"Drilling of 165MM DIA BOREWELL AT Sharada Nagara, V.V.Nagara in ward no.197, Vasanthapura",Vijay Kumar A9986096015,BR - 000146 / 12-Sep-2016CBR - 004548 / 28-Jul-2018Rtgs - 000152 / 03-Aug-2018,1967500,1716910,250590
108882,197-16-000008,Reserve fund for Emergency works in ward no 197 Vasanthapura.,Vijay Kumar A9986096015,BR - 000123 / 30-Jun-2016CBR - 004992 / 08-Aug-2018Rtgs - 000170 / 14-Aug-2018,2248000,1931150,316850
107869,197-15-000034,Providing cross roads Ornamental boards painting at K S R T C Layout Sarvabhomanagara Ramanjaneya Layout and surrounding areas in ward no 197,KRIDL9986096015,BR - 000125 / 30-Aug-2016CBR - 004993 / 08-Aug-2018Rtgs - 000170 / 14-Aug-2018,1000000,822900,177100
107984,197-16-000044,Improvements to drains and roads at Ganapathipura Govind Reddy layout in ward no 197 Vasanthapura,KRIDL9986096015,BR - 000127 / 30-Aug-2016CBR - 004994 / 08-Aug-2018Rtgs - 000170 / 14-Aug-2018,4899000,4085660,813340
108069,197-16-000046,Improvements to drains and roads at Ganapathipura cross roads in ward no 197 Vasanthapura,KRIDL9986096015,BR - 000155 / 12-Sep-2016CBR - 004997 / 08-Aug-2018Rtgs - 000170 / 14-Aug-2018,4898980,4084540,814440
108035,197-16-000043,Improvements to drains and roads at Canara Bank road in ward no 197 Vasanthapura,KRIDL9986096015,BR - 000157 / 12-Sep-2016CBR - 004998 / 08-Aug-2018Rtgs - 000170 / 14-Aug-2018,4899000,4086450,812550
108001,197-16-000045,Improvements to drains and roads at Konanakunte cross roads in ward no 197 Vasanthapura,KRIDL9986096015,BR - 000156 / 16-Sep-2016CBR - 005048 / 10-Aug-2018Rtgs - 000170 / 14-Aug-2018,4899400,4084420,814980
107973,197-16-000009,Drilling of 165 mm Dia New borewell and providing electrification and distribution of pipe line in ward no 197 vasanthapura,Vijay kumar A9986096015,BR - 000126 / 30-Aug-2016CBR - 005050 / 10-Aug-2018Rtgs - 000170 / 14-Aug-2018,1529500,1334300,195200
83541,197-16-000052,Improvements to roads and drains in Vasanthapura ward no 197,SURESH B N8050659434,BR - 000298 / 31-Mar-2017CBR - 005075 / 10-Aug-2018Rtgs - 000170 / 14-Aug-2018,368000,321800,46200
106740,197-16-000053,Construction of Shuttle Court in ward no 197 Vasanthapura,KRIDL9886827056,BR - 000291 / 31-Mar-2017CBR - 005186 / 14-Aug-2018Rtgs - 000174 / 18-Aug-2018,9861200,8373060,1488140
88665,197-14-000025,EMERGENCY WORKS IN WARD NO 197 VASANTHAPURA,narasimha swamy9986096015,BR - 000150 / 01-Oct-2015CBR - 005565 / 30-Aug-2018Rtgs - 000188 / 03-Sep-2018,1560000,1353000,207000
106296,197-17-000007,Maintenance of UGD system in ward no.197 Vasanthapura,H B Boregowda9900155965,BR - 000098 / 30-Jun-2017CBR - 005485 / 28-Aug-2018Rtgs - 000189 / 03-Sep-2018,2057300,1776540,280760
90142,197-17-000009,Providing UGD lines and Missed links in ward no.197 Vasanthapura,HARISH CONSTRUCTION C.RAMAMURTHY9448068702,BR - 000007 / 28-Apr-2017CBR - 005888 / 24-Sep-2018Rtgs - 000217 / 27-Sep-2018,1765500,1504620,260880
100826,197-17-000053,Improvements Drain and Culvert near Shuttle Court Stadium at Bikasipura in ward no 197,KRIDL9448085873,BR - 000037 / 17-May-2017CBR - 006577 / 10-Oct-2018Rtgs - 000243 / 16-Oct-2018,3798170,3186550,611620
193862,197-18-000079,Providing LED Street light fittings in ward no 197 Vasanthapura,M/s. Executive Engineer-01 9945510720,BR - 000034 / 17-Sep-2018CBR - 006803 / 16-Oct-2018Rtgs - 000245 / 17-Oct-2018,995961,887391,108570
107842,197-15-000025,"Providing ornamental name boards and cross boards, painting etc in ward no 197",KRIDL9986096015,BR - 000060 / 20-Jul-2016CBR - 006921 / 25-Oct-2018Rtgs - 000254 / 30-Oct-2018,1630000,1357650,272350
88213,197-15-000012,Improvements and asphalting the main roads of Udaya nagara in ward no 197 Vasanthapura,Uday kumar k9845183166,BR - 000050 / 29-May-2015CBR - 006926 / 25-Oct-2018Rtgs - 000254 / 30-Oct-2018,2167110,1859340,307770
189035,197-17-000044,Development of roads and drains in ward no 197,Sri K Uday Kumar9845183166,BR - 000253 / 26-Sep-2018CBR - 007156 / 30-Oct-2018Rtgs - 000256 / 31-Oct-2018,4344000,3872810,471190
197122,197-17-000059,Providing drinking water works in Ward No 197 in Bangalore South Division ,Sri H B Boregowda9900155965,BR - 000272 / 30-Oct-2018CBR - 008050 / 17-Dec-2018Rtgs - 000296 / 19-Dec-2018,1248900,1117050,131850
166621,197-18-000006,Improvements to CC road drain culverts at A K Colony at Chikkalasandra and surrounding areas in ward no 197,M/s KRIDL9886631704,BR - 000142 / 31-May-2018CBR - 007894 / 11-Dec-2018Rtgs - 000297 / 19-Dec-2018,3999700,3435720,563980
166613,197-18-000004,Improvements to CC road drain culverts at Vasanthapura grama and surrounding areas in ward no 197,M/s KRIDL9886631704,BR - 000143 / 31-May-2018CBR - 007895 / 11-Dec-2018Rtgs - 000297 / 19-Dec-2018,6997900,6011100,986800
166601,197-18-000005,Improvements to CC road drain culverts at ayyappanagara and surrounding areas in ward no 197,M/s KRIDL9886631704,BR - 000144 / 31-May-2018CBR - 007896 / 11-Dec-2018Rtgs - 000297 / 19-Dec-2018,3998500,3436600,561900
126944,197-17-000008,Maintaince of Water Supply system in ward no.197 Vasanthapura,H B Boregowda9900155965,BR - 000008 / 29-Dec-2017CBR - 007991 / 14-Dec-2018Rtgs - 000298 / 20-Dec-2018,1074400,964630,109770
201611,197-18-000077,Providing Asphalting to Muniredy layout Doddakalsandra in Ward No 197 ,M/s KRIDL9036405669,BR - 000293 / 31-Oct-2018CBR - 008349 / 29-Dec-2018Rtgs - 000309 / 01-Jan-2019,4999000,4289070,709930
201632,197-18-000073,Improvements to Concrete Roads. Drain and Culvert Maheshwaramma Temple Street and Surroundings at Konanakuntae in Ward No 197 ,M/s KRIDL9036405669,BR - 000296 / 31-Oct-2018CBR - 008350 / 29-Dec-2018Rtgs - 000309 / 01-Jan-2019,4995000,4290450,704550
201618,197-18-000076,Providing Asphalting to Main Roads at VV Nagar 2nd block in Ward No 197 ,M/s KRIDL9036405669,BR - 000294 / 31-Oct-2018CBR - 008351 / 29-Dec-2018Rtgs - 000309 / 01-Jan-2019,4997800,4282990,714810
201613,197-18-000078,Providing Asphalting in Navarathna Garden in Ward No 197,M/s KRIDL9036405669,BR - 000298 / 31-Oct-2018CBR - 008352 / 29-Dec-2018Rtgs - 000309 / 01-Jan-2019,4999000,4284070,714930
201610,197-18-000075,Improvements to Drains and providing Asphalting to VV Nagar 1st Block in Ward No197 ,M/s KRIDL9036405669,BR - 000299 / 31-Oct-2018CBR - 008353 / 29-Dec-2018Rtgs - 000309 / 01-Jan-2019,4998000,4294190,703810
203652,197-18-000070,Providing Concrete Roads. Drain and Culvert at Konanakuntae JSS School Road and crosses in Ward No 197 ,M/s KRIDL9036405669,BR - 000302 / 05-Nov-2018CBR - 008357 / 29-Dec-2018Rtgs - 000309 / 01-Jan-2019,4992000,4332750,659250
201620,197-18-000069,Improvements to Concrete Roads. Drain and Culvert at Konanakuntae Grama in Ward No 197 ,KRIDL9036405669,BR - 000303 / 14-Nov-2018CBR - 008428 / 29-Dec-2018Rtgs - 000309 / 01-Jan-2019,4998000,4294190,703810
201621,197-18-000072,Providing Asphalting to Main Roads of PNB Layout in Ward No197 ,M/s KRIDL9036405669,BR - 000297 / 31-Oct-2018CBR - 008429 / 29-Dec-2018Rtgs - 000309 / 01-Jan-2019,4999000,4285070,713930
201617,197-18-000071,Providing Asphalting ot 1st and 2nd Main and Cross Roads at Ramanjaneyya Nagar in Ward No197 ,M/s KRIDL9036405669,BR - 000300 / 31-Oct-2018CBR - 008430 / 29-Dec-2018Rtgs - 000309 / 01-Jan-2019,4999000,4290020,708980
201609,197-18-000074,Improvements to Concrete Roads. Drain and Culvert at Konankuntae cross in Ward No 197 ,M/s KRIDL9036405669,BR - 000292 / 31-Oct-2018CBR - 008431 / 29-Dec-2018Rtgs - 000309 / 01-Jan-2019,4996800,4297090,699710
166610,197-18-000065,Improvements to Indira Canteen at Vasanthapura Gutte in ward no.197 Vasanthapura ,M/s KRIDL9886631704,BR - 000146 / 31-May-2018CBR - 008026 / 17-Dec-2018Rtgs - 000311 / 02-Jan-2019,2646700,2325500,321200
166616,197-18-000064,Improvements to Indira Canteen at Jai Kumar Layout in Govt Hospital premises Konanakunte in ward no.195 in ward no.197 ,M/s KRIDL9886631704,BR - 000147 / 31-May-2018CBR - 008027 / 17-Dec-2018Rtgs - 000311 / 02-Jan-2019,1108300,973800,134500
101221,197-17-000054,Providing Asphalting roads near Shuttle Court Stadium at Bikasipura in ward no 197,KRIDL9448085873,BR - 000087 / 24-Jun-2017CBR - 008200 / 21-Dec-2018Rtgs - 000321 / 10-Jan-2019,1199730,1005345,194385
159027,197-17-000042,Providing Drinking Water through Water tankers in Ward no.197 Vasanthapura,Sri B K Vinod Kumar9845222227,BR - 000045 / 30-Apr-2018CBR - 008796 / 18-Jan-2019Rtgs - 000329 / 19-Jan-2019,484515,473685,10830
203543,197-18-000044,Providing Drinking Water through drilling of New Borewells at Venkatareddy Layout and VV Nagar 1st Stage in Ward No-197 ,"M/s Harish Constructions, Sri C Ramamoorthy9448068702",BR - 000339 / 24-Dec-2018CBR - 009043 / 05-Feb-2019Rtgs - 000339 / 05-Feb-2019,1970000,1745370,224630
166435,197-17-000051,Engagement of Gangman and Hiring of Tractor Tippers for cleaning and Maintenance of road side drains and other cleaning works in works in ward no 197,Sri K S Srinivasan9448085873,BR - 000119 / 31-May-2018CBR - 009247 / 14-Feb-2019Rtgs - 000353 / 15-Feb-2019,1103600,995480,108120
214994,197-18-000047,Improvements to Roads and Footpath at Vasanthapura in Ward No-197,Sri Venkatakrishna7259032791,BR - 000347 / 29-Dec-2018CBR - 009619 / 05-Mar-2019Rtgs - 000369 / 07-Mar-2019,1497600,1318808,178792
139535,197-18-000003,Providing street lights control switches and connected accessories in Vasanthapura in ward no 197, M/s.Executive Engineer-01 KRIDL9480683443,BR - 000053 / 24-Jan-2018CBR - 009481 / 01-Mar-2019Rtgs - 000371 / 07-Mar-2019,2986143,2600913,385230
110319,197-17-000006,Potholes filling at Vasanthapura and Doddakalasandra in ward no 197 Vasanthapura,"M/s Srusti Infrastructure, Proop. Sri.A.Vijay Kumar9986096015",BR - 000143 / 30-Jun-2017CBR - 009741 / 14-Mar-2019Rtgs - 000376 / 15-Mar-2019,1960000,1653000,307000
164285,197-17-000016,Providing Drinking Water through Water tankers in ward no.197 Vasanthapura,H B Boregowda9900155965,BR - 000114 / 30-May-2018CBR - 009784 / 14-Mar-2019Rtgs - 000378 / 20-Mar-2019,996300,894340,101960
187468,197-16-000001,Annual Operation and Maintenance of street lighting system in ward no-197 Package B14 of Bommanahalli zone.,M/s Sri Venkateswara Electricals9945811466,BR - 000022 / 21-Aug-2018CBR - 000372 / 11-Apr-2019Rtgs - 000017 / 12-Apr-2019,200194,178854,21340
187488,197-16-000001,Annual Operation and Maintenance of street lighting system in ward no-197 Package B14 of Bommanahalli zone.,M/s Sri Venkateswara Electricals9945811466,BR - 000023 / 21-Aug-2018CBR - 000373 / 11-Apr-2019Rtgs - 000017 / 12-Apr-2019,800776,714876,85900
187538,197-16-000001,Annual Operation and Maintenance of street lighting system in ward no-197 Package B14 of Bommanahalli zone.,M/s Sri Venkateswara Electricals9945811466,BR - 000024 / 21-Aug-2018CBR - 000374 / 11-Apr-2019Rtgs - 000017 / 12-Apr-2019,400388,358020,42368
223313,197-16-000001,Annual Operation and Maintenance of street lighting system in ward no-197 Package B14 of Bommanahalli zone.,M/s Sri Venkateswara Electricals9945811466,BR - 000082 / 19-Jan-2019CBR - 000839 / 23-Apr-2019Rtgs - 000029 / 25-Apr-2019,1000970,867106,133864
243671,197-19-000038,Restoration of Road cut portion done by BWSSB -BESCOM-KPTCL in 197 in Bengaluru South Division roads under BBMP Limits Phase-1,M Ramesh9845057449,BR - 000012 / 27-Apr-2019CBR - 001224 / 29-Apr-2019Rtgs - 000034 / 03-May-2019,7521000,7190346,330654
245404,197-19-000038,Restoration of Road cut portion done by BWSSB -BESCOM-KPTCL in 197 in Bengaluru South Division roads under BBMP Limits Phase-1,M Ramesh9845057449,BR - 000053 / 08-May-2019CBR - 001476 / 13-May-2019Rtgs - 000044 / 15-May-2019,2390470,2280084,110386
246558,197-16-000001,Annual Operation and Maintenance of street lighting system in ward no-197 Package B14 of Bommanahalli zone.,M/s Sri Venkateswara Electricals9945811466,BR - 000004 / 10-May-2019CBR - 002341 / 01-Jun-2019Rtgs - 000073 / 07-Jun-2019,800776,694066,106710
131552,197-17-000018,Improvements CC Road drain at Naidu layout in ward no 197 Vasanthapura,Yogananda9845710489,BR - 000001 / 27-Dec-2017CBR - 002600 / 11-Jun-2019Rtgs - 000076 / 12-Jun-2019,4769600,4166200,603400
133210,197-17-000013,Reserve fund for Emergency works in ward no 197 Vasanthapura,"M/s Harish Constructions, Prop. Sri C Ramamoorthy9448068702",BR - 000012 / 30-Dec-2017CBR - 002659 / 12-Jun-2019Rtgs - 000088 / 18-Jun-2019,2897140,2516910,380230
133257,197-17-000026,Improvements to Drains and Culverts at Sharadha Nagara in ward no 197 Vasanthapura,"M/s Harish Constructions, Prop. Sri C Ramamoorthy9448068702",BR - 000013 / 30-Dec-2017CBR - 002660 / 12-Jun-2019Rtgs - 000088 / 18-Jun-2019,4896250,4232120,664130
217559,197-18-000043,Improvements and Maintanance of Samudhaya Bhavana building in Ward No-197,Manjunath K R9902833363,BR - 000351 / 31-Dec-2018CBR - 002825 / 19-Jun-2019Rtgs - 000093 / 25-Jun-2019,480000,431628,48372
218842,197-18-000048,Improvements and Maintanance of SWM in Ward No-197 ,N Nagaraju9448064004,BR - 000401 / 05-Feb-2019CBR - 002940 / 21-Jun-2019Rtgs - 000093 / 25-Jun-2019,1454000,1308296,145704
136037,197-17-000010,Improvements to drains and roads at Udayanagara 2nd cross in ward no.197 Vasanthapura,H B Boregowda9900155965,BR - 000079 / 24-Feb-2018CBR - 003868 / 20-Jul-2019Rtgs - 000125 / 25-Jul-2019,3806900,3333050,473850
264425,197-20-000014,Restoration of road cut portion done by BWSSB for water supply pipe line in Vasanthapura Sreedharashram road and Kuvempunagara road and surrounding areas of ward no 197 in Bangaluru South Division roads under BBMP limits Phase-2,M Ramesh9845057449,BR - 000111 / 22-Jul-2019CBR - 003960 / 24-Jul-2019Rtgs - 000126 / 25-Jul-2019,7344500,7020058,324442
178497,197-17-000003,Existing to be shifting of borewell at Konanakunte signal and UGD line at Doddakalsandra Kanakapura main road in ward no 197 Vasanthapura,Sri H B Boregowda9900155965,BR - 000185 / 27-Jul-2018CBR - 004097 / 26-Jul-2019Rtgs - 000136 / 31-Jul-2019,2110400,1875790,234610
146712,197-17-000028,Improvements and asphalting to Cross Roads at Sharadha Nagar in ward no 197,"M/s Vrushab Infrastructure, Prop, Sri B K Mahesh reddy9902963559",BR - 000140 / 13-Mar-2018CBR - 004386 / 09-Aug-2019Rtgs - 000158 / 19-Aug-2019,4445500,3907630,537870
146707,197-17-000019,Improvements and Asphalting to Road from Naidu layout to Manago garden in ward no 197 Vasanthapura ,"M/s Vrushab Infrastructure, Prop Sri B K Mahesh Reddy9902963559",BR - 000141 / 13-Mar-2018CBR - 004387 / 09-Aug-2019Rtgs - 000158 / 19-Aug-2019,4495000,3882920,612080
146716,197-17-000017,Improvements and Asphalting to Deodite Public school in ward no 197 Vasanthapura ,"M/s Vrushab Infrastructure, Prop. Sri B K Mahesh Reddy9902963559",BR - 000142 / 13-Mar-2018CBR - 004388 / 09-Aug-2019Rtgs - 000158 / 19-Aug-2019,4913400,4246230,667170
146722,197-17-000029,Improvements and asphalting to 1st and 2nd main road at Sharadha Nagar in ward no 197 Vasanthapura,"M/s Vrushab Infrastructure, Prop Sri B K Mahesh reddy9902963559",BR - 000143 / 13-Mar-2018CBR - 004389 / 09-Aug-2019Rtgs - 000158 / 19-Aug-2019,4545000,3913650,631350
146665,197-17-000021,Improvements and Asphalting Om Shakthi temple road and Uma Maheshwari layout Doddakallsandra in ward no 197 Vasanthapura,"M/s Vrushab Infrastructure, Prop Sri B K Mahesh Reddy9902963559",BR - 000144 / 13-Mar-2018CBR - 004390 / 09-Aug-2019Rtgs - 000158 / 19-Aug-2019,3685900,3178510,507390
267750,197-16-000001,Annual Operation and Maintenance of street lighting system in ward no-197 Package B14 of Bommanahalli zone.,M/s Sri Venkateswara Electricals9945811466,BR - 000034 / 07-Aug-2019CBR - 004899 / 03-Sep-2019Rtgs - 000179 / 11-Sep-2019,600581,516173,84408
164289,197-17-000004,Maintainance of engaging tractor and labour in ward no 197 Vasanthapura,H B Boregowda9900155965,BR - 000113 / 30-May-2018CBR - 005210 / 19-Sep-2019Rtgs - 000197 / 23-Sep-2019,1987800,1774590,213210
161354,197-18-000020,Improvements to Drain at Main roads in Sarvabhomanagar in Ward No-197,Sri Somashekar G8147005868,BR - 000047 / 30-Apr-2018CBR - 005602 / 01-Oct-2019Rtgs - 000226 / 19-Oct-2019,2876600,2508920,367680
161349,197-18-000018,Improvements and Asphalting at 7 Hills Layout Chikkalsandra in Ward No-197,Sri Somashekar G8147005868,BR - 000048 / 30-Apr-2018CBR - 005603 / 01-Oct-2019Rtgs - 000226 / 19-Oct-2019,2848700,2484180,364520
165505,197-17-000014,Providing Streetlights and Switches in ward no.197 Vasanthapura,M/s Himagiri Sree Electrical7892710027,BR - 000005 / 07-Jun-2018CBR - 006227 / 14-Nov-2019Rtgs - 000277 / 26-Nov-2019,1926008,1841255,84753
108414,197-16-000002,Annual maintainance engaging tractor and labour in ward no. 197 Vasanthapura,Vijay Kumar A9986096015,BR - 000144 / 30-Jun-2017CBR - 006314 / 22-Nov-2019Rtgs - 000279 / 26-Nov-2019,1864000,1628020,235980
274413,197-18-000046,Improvements of UGD System in Vasantapura Ward No-197 ,Rajanna M9902833363,BR - 000155 / 31-Aug-2019CBR - 006401 / 25-Nov-2019Rtgs - 000286 / 02-Dec-2019,1372000,1204580,167420
274223,197-18-000042,Improvements and Maintanance of Burrial Ground in Ward No-197 ,Rajanna M9902833363,BR - 000154 / 31-Aug-2019CBR - 006402 / 25-Nov-2019Rtgs - 000286 / 02-Dec-2019,420700,371286,49414
166383,197-18-000056,Improvements to roads and drains at 9th cross and Abbaiah naidu Studio surrounding road in ward no.197 Vasanthapura,Sri Somashekar Gangadaraiah9902833363,BR - 000121 / 31-May-2018CBR - 006799 / 12-Dec-2019Rtgs - 000327 / 04-Jan-2020,3789000,3308500,480500
166389,197-18-000017,Improvements and Asphalting at Doctors Colony Chikkalsandra in Ward No-197,Sri Somashekar G8147005868,BR - 000122 / 31-May-2018CBR - 006800 / 12-Dec-2019Rtgs - 000327 / 04-Jan-2020,3677000,3206400,470600
166662,197-18-000027,Improvements to Roads and Asphalting at Prashanthi Nagar in Ward No-197,Sri Nanjundeshwara Enterprises9036405669,BR - 000139 / 31-May-2018CBR - 007583 / 17-Jan-2020Rtgs - 000354 / 18-Jan-2020,3815000,3308725,506275
149882,197-17-000012,Improvements to drains and roads at Simha layout in ward no.197 Vasanthapura,Nanjundeshwara Enterprises1234567891,BR - 000189 / 31-Mar-2018CBR - 007592 / 17-Jan-2020Rtgs - 000354 / 18-Jan-2020,4880000,4345200,534800
166667,197-18-000024,Improvements to Roads and Asphalting at Vittal Nagar 1st Stage in Ward No-197,Sri Nanjundeshwara Enterprises9036405669,BR - 000137 / 31-May-2018CBR - 007596 / 18-Jan-2020Rtgs - 000354 / 18-Jan-2020,2880000,2490200,389800
166664,197-18-000025,Improvements to Roads and Asphalting at Maruthi Layout in Ward No-197,Sri Nanjundeshwara Enterprises9036405669,BR - 000136 / 31-May-2018CBR - 007598 / 18-Jan-2020Rtgs - 000354 / 18-Jan-2020,3870000,3364050,505950
166669,197-18-000019,Improvements and Asphalting roads at Ramanjaneyanagar in Ward No-197,Sri Nanjundeshwara Enterprises9036405669,BR - 000138 / 31-May-2018CBR - 007599 / 18-Jan-2020Rtgs - 000354 / 18-Jan-2020,3817000,3293460,523540
178488,197-18-000031,Improvements to Drain and Culverts at Gokulnagar in Ward No-197,Sri H B Boregowda9900155965,BR - 000186 / 27-Jul-2018CBR - 007824 / 20-Jan-2020Rtgs - 000359 / 21-Jan-2020,2795500,2441950,353550
178805,197-18-000021,"Improvements CC Road, Drain at Gowdanpalya Crosses and Surrounding area in Ward No-197",Sri M Nagaraja7353595999,BR - 000192 / 31-Jul-2018CBR - 008040 / 24-Jan-2020Rtgs - 000370 / 03-Feb-2020,3600400,3155970,444430
181353,197-18-000028,Improvements to Drain and Culvert at Prashanthi Nagar in Ward No-197,Sri Prakash9845752097,BR - 000194 / 31-Jul-2018CBR - 008041 / 24-Jan-2020Rtgs - 000370 / 03-Feb-2020,3750000,3266750,483250
328721,197-20-000028,Improvements to roads and drains in VV Nagar 2nd Block of Ward No 197 Annex 02 Sl No 827,M/s KRIDL9480828220,BR - 000316 / 19-Mar-2020CBR - 009608 / 31-Mar-2020Rtgs - 000009 / 02-Apr-2020,19659000,17685270,1973730
183640,197-18-000061,Improvements to drains works at Ramanjaneya layout in ward no.197 Vasanthapura,Sri Prakasha B K9480339113,BR - 000205 / 14-Aug-2018CBR - 009099 / 17-Mar-2020Rtgs - 000023 / 21-May-2020,1796800,1572930,223870
331106,197-16-000001,Annual Operation and Maintenance of street lighting system in ward no-197 Package B14 of Bommanahalli zone.,M/s Sri Venkateswara Electricals9945811466,BR - 000004 / 14-Apr-2020CBR - 000472 / 28-May-2020Rtgs - 000056 / 02-Jun-2020,1601551,1406933,194618
306392,197-19-000035,Providing Lighting and CC Camera for Corporator Office and Skating Rink at Bikasipura in ward no 197 Vasanthapura,Venkataramu9900007121,BR - 000277 / 18-Jan-2020CBR - 000985 / 19-Jun-2020Rtgs - 000087 / 23-Jun-2020,800170,707867,92303
189482,197-18-000008,Drilling of 165mm Dia New Borewell 5 Nos And Providing electrification and Disturbution of Pipe line at Vasanthapura in ward no 197,M/s KRIDL9448475620,BR - 000283 / 31-Oct-2018CBR - 001022 / 22-Jun-2020Rtgs - 000094 / 25-Jun-2020,4916790,4294680,622110
195080,197-18-000055,Emergency Reserve fund for ward no.197,Sri S Srinivasan9742345283,BR - 000254 / 28-Sep-2018CBR - 001134 / 24-Jun-2020Rtgs - 000095 / 26-Jun-2020,2565200,2259150,306050
225831,197-18-000057,Improvements to CC Road 1st to 4th cross in Ramanjaneyanagara in ward no.197 Vasanthapura,H R Laleen Kumar 9686200430,BR - 000402 / 07-Feb-2019CBR - 001030 / 23-Jun-2020Rtgs - 000096 / 26-Jun-2020,1997000,1749520,247480
225845,197-18-000059,Improvements to drains and Asphalting to 1st and 2nd cross in Soudhamini layout in ward no.197 Vasanthapura,Sri H R Laleen Kumar9686200430,BR - 000403 / 07-Feb-2019CBR - 001031 / 23-Jun-2020Rtgs - 000096 / 26-Jun-2020,1997000,255520,1741480
241681,197-18-000030,Improvements to Roads and Asphalting at Gokulnagar in Ward No-197,Sri Nanjundeshwara Enterprises9036405669,BR - 000029 / 29-Apr-2019CBR - 001324 / 26-Jun-2020Rtgs - 000101 / 26-Jun-2020,4716800,4077422,639378
241687,197-18-000016,Improvements to drain and Asphalting at Udaynagar 1st Cross in Ward No-197,Sri G Ravi Kumar9036405669,BR - 000028 / 29-Apr-2019CBR - 001325 / 26-Jun-2020Rtgs - 000101 / 26-Jun-2020,2725000,2377390,347610
241787,197-18-000022,Improvements and Asphalting to Cross Roads at Canara Bank Colony Chikkalsandra in Ward No-197,Sri Nanjundeshwara Enterprises9036405669,BR - 000030 / 29-Apr-2019CBR - 001326 / 26-Jun-2020Rtgs - 000101 / 26-Jun-2020,3779000,3265488,513512
241680,197-18-000026,Improvements to Roads and Asphalting at KalyaniNagar in Ward No-197,Sri Nanjundeshwara Enterprises9036405669,BR - 000031 / 29-Apr-2019CBR - 001327 / 26-Jun-2020Rtgs - 000102 / 26-Jun-2020,4795500,4151166,644334
195085,197-18-000080,Providing Asphalting to 6th cross Maruthi Layout in ward no 197,M/s KRIDL9880566223,BR - 000256 / 29-Sep-2018CBR - 001224 / 25-Jun-2020Rtgs - 000104 / 01-Jul-2020,1999650,1707670,291980
195089,197-18-000081,Providing Asphalting to Desai Garden in ward no 197,M/s KRIDL9880566223,BR - 000258 / 29-Sep-2018CBR - 001227 / 25-Jun-2020Rtgs - 000104 / 01-Jul-2020,1999850,1707850,292000
195087,197-18-000083,Providing Asphalting to PNB Layout in ward no 197,M/s KRIDL9880566223,BR - 000257 / 29-Sep-2018CBR - 001230 / 25-Jun-2020Rtgs - 000104 / 01-Jul-2020,1999800,1707800,292000
195086,197-18-000082,Providing Asphalting to Vital Nagara in ward no 197,M/s KRIDL9880566223,BR - 000259 / 29-Sep-2018CBR - 001231 / 25-Jun-2020Rtgs - 000104 / 01-Jul-2020,3498000,2987100,510900
317076,197-19-000001,Providing Asphalting to 2nd 3rd 4th 5th main and cross roads at Maruthi layout in ward no 197,M/s KRIDL9945510720,BR - 000290 / 07-Feb-2020CBR - 001356 / 29-Jun-2020Rtgs - 000109 / 01-Jul-2020,4951000,4288570,662430
273487,197-18-000001,Providing Fencing to BBMP Property at Bikasipura in ward no 197 Vasanthapura,Sri V T Mahesh9886827056,BR - 000158 / 31-Aug-2019CBR - 001363 / 29-Jun-2020Rtgs - 000110 / 01-Jul-2020,3351900,2949184,402716
273375,197-16-000042,Construction of Office at Bikasipura BBMP Property in ward.197 ,Sri V T Mahesh9886827056,BR - 000156 / 31-Aug-2019CBR - 001364 / 29-Jun-2020Rtgs - 000110 / 01-Jul-2020,2265450,2013516,251934
273309,197-18-000040,Construction of Todlers In-Door Play Park Building at Bikasipura BBMP property in ward no 197,M/s KRIDL9900055499,BR - 000157 / 31-Aug-2019CBR - 001365 / 29-Jun-2020Rtgs - 000110 / 01-Jul-2020,5983200,5214118,769082
315161,197-19-000016,Providing Asphalting to 18th main and cross roads Narayananagara 1st stage in ward no 197,Girish J9036405669,BR - 000286 / 31-Jan-2020CBR - 001368 / 29-Jun-2020Rtgs - 000110 / 01-Jul-2020,4697700,4201772,495928
315157,197-19-000013,Improvements to roads and asphalting at 8th and 9th cross Vallabhanagara in ward no 197,Girish J9036405669,BR - 000287 / 31-Jan-2020CBR - 001369 / 29-Jun-2020Rtgs - 000110 / 01-Jul-2020,2908700,2601492,307208
196990,197-18-000039,Providing Water Supply Lines in Ward Limit of Ward No-197,Sri H B Boregowda9900155965,BR - 000271 / 30-Oct-2018CBR - 001376 / 29-Jun-2020Rtgs - 000135 / 04-Jul-2020,2901500,2584950,316550
196954,197-18-000053,Maintaince of Water Supply system in ward no.197 Vasanthapura,Sri H B Boregowda9900155965,BR - 000273 / 30-Oct-2018CBR - 001377 / 29-Jun-2020Rtgs - 000135 / 04-Jul-2020,985500,884500,101000
323377,197-18-000007,"UGD works at Doddakallasandra and surrounding are in ward No.197, Vasanthapura",M/s KRIDL9986096015,BR - 000002 / 20-Apr-2020CBR - 001597 / 06-Jul-2020Rtgs - 000141 / 07-Jul-2020,7998000,6859368,1138632
330284,197-20-000027,Improvements of roads and Drains in Vittalanagar of Ward No 197 Annex 02 Sl No 826,M/s KRIDL9480828220,BR - 000325 / 26-Mar-2020CBR - 002407 / 20-Oct-2020Rtgs - 000199 / 22-Oct-2020,19639800,17890360,1749440
330281,197-20-000025,Improvements of roads and Drains in Maruthi layout of Ward No 197 Annex 02 Sl No 824,M/s KRIDL9480828220,BR - 000326 / 26-Mar-2020CBR - 002408 / 20-Oct-2020Rtgs - 000199 / 22-Oct-2020,19661000,17899530,1761470
330274,197-20-000029,Improvements to roads and Drains in Sharadhanagar of Ward No 197 Annex 02 SL No 828,M/s KRIDL9480828220,BR - 000327 / 26-Mar-2020CBR - 002414 / 20-Oct-2020Rtgs - 000199 / 22-Oct-2020,9816500,8881645,934855
330265,197-20-000024,Comprehensive Development of roads and drains in Kuvempunagara and surrounding areas in ward no 197 Vasanthapura Annex 02 Sl No 823,M/s KRIDL9480828220,BR - 000328 / 26-Mar-2020CBR - 002416 / 20-Oct-2020Rtgs - 000199 / 22-Oct-2020,19659000,17877270,1781730
330286,197-20-000026,Improvements of roads and Drains in BSK 5th Stage of Ward No 197 Annex 02 Sl No 825,M/s KRIDL9480828220,BR - 000329 / 26-Mar-2020CBR - 002417 / 20-Oct-2020Rtgs - 000199 / 22-Oct-2020,9823000,8909010,913990
343386,197-16-000001,Annual Operation and Maintenance of street lighting system in ward no-197 Package B14 of Bommanahalli zone.,M/s Sri Venkateswara Electricals9945811466,BR - 000037 / 08-Jun-2020CBR - 001819 / 11-Jul-2020Rtgs - 000214 / 26-Nov-2020,400388,352483,47905
196982,197-18-000052,Maintenance of UGD system in ward no.197 Vasanthapura,Sri H B Boregowda9900155965,BR - 000269 / 30-Oct-2018CBR - 001975 / 16-Jul-2020Rtgs - 000216 / 27-Nov-2020,1998200,1774330,223870
196997,197-18-000033,"Improvements CC Road, Drain at AK Colony Doddakalsandra and Surrounding areas in Ward No-197",Sri H B Boregowda9900155965,BR - 000270 / 30-Oct-2018CBR - 001976 / 16-Jul-2020Rtgs - 000216 / 27-Nov-2020,2665000,2327500,337500
384893,197-16-000001,Annual Operation and Maintenance of street lighting system in ward no-197 Package B14 of Bommanahalli zone.,M/s Sri Venkateswara Electricals9945811466,BR - 000053 / 18-Nov-2020CBR - 003224 / 09-Dec-2020Rtgs - 000230 / 15-Dec-2020,800775,699569,101206
217563,197-18-000063,Providing Linking Pipeline for Water supply in ward no.197 Vasanthapura,Sri Manjunath K R9902833363,BR - 000352 / 31-Dec-2018CBR - 003364 / 11-Dec-2020Rtgs - 000233 / 16-Dec-2020,941940,845920,96020
333890,197-20-000003,Providing concrete roads at Hari Hara Bhavan road and surrounding areas in Vasanthapura Ward 197,M/s KRIDL9480828220,BR - 000041 / 07-May-2020CBR - 003582 / 23-Dec-2020Rtgs - 000240 / 24-Dec-2020,9780900,8890280,890620
382354,197-20-000012,Improvements to roads. drains. culverts at 6th to 12th main Ganapathipura in Vasanthpura,M/s KRIDL9480828220,BR - 000283 / 30-Nov-2020CBR - 003849 / 24-Dec-2020Rtgs - 000241 / 28-Dec-2020,9784200,8883406,900794
382590,197-20-000004,Improvements to roads. drains and culverts at1st to 5th main Ganapathipura in Ward No 197,M/s KRIDL9480828220,BR - 000284 / 30-Nov-2020CBR - 003875 / 24-Dec-2020Rtgs - 000241 / 28-Dec-2020,9781400,8879302,902098
382341,197-20-000008,Improvements to drain and culverts at AK colony doddakalasandra from Kankpura Main road to Kumarans school in Ward 197,M/s KRIDL9480828220,BR - 000282 / 30-Nov-2020CBR - 003911 / 24-Dec-2020Rtgs - 000241 / 28-Dec-2020,9784000,8882220,901780
381243,197-20-000010,Construction of RCC drain and culvert at Sharadhanagar in Vasanthpura in Ward No.197,M/s KRIDL9480828220,BR - 000313 / 10-Dec-2020CBR - 003923 / 24-Dec-2020Rtgs - 000241 / 28-Dec-2020,9899000,8992170,906830
347968,197-19-000029,Improvements and Maintenance of Community building and parks in ward no 197,G K Maruthi Kumar9886827056,BR - 000099 / 25-Jun-2020CBR - 003950 / 01-Jan-2021Rtgs - 000251 / 08-Jan-2021,420570,389413,31157
375088,197-19-000031,Maintenance of Public toilet and Spetage in ward no 197,Mahesh V T9886827056,BR - 000233 / 27-Oct-2020CBR - 003984 / 02-Jan-2021Rtgs - 000251 / 08-Jan-2021,420000,377600,42400
169915,197-18-000012,Improvements to drain and Culverts at Satyammanakuntae and surrounding area in ward no.197,M/s KRIDL9483957399,BR - 000274 / 31-Oct-2018CBR - 002014 / 17-Jul-2020Rtgs - 000254 / 15-Jan-2021,6990000,6004100,985900
169907,197-18-000014,Improvements and Asphalting at Canara Bank Colony at Chikkalsandra in ward no.197,M/s KRIDL9483957399,BR - 000276 / 31-Oct-2018CBR - 002016 / 17-Jul-2020Rtgs - 000254 / 15-Jan-2021,3970000,3390850,579150
201144,197-18-000010,Improvements to Drain and Culvert at Kuvempunagara Aishwaraya layout and surrounding areas in ward no.197,M/s KRIDL9483957399,BR - 000278 / 31-Oct-2018CBR - 002022 / 17-Jul-2020Rtgs - 000254 / 15-Jan-2021,7999000,6841020,1157980
372516,197-19-000032,Upgradation of UGD System at Vasanthapura Doddakalsandra in ward no 197,H B Boregowda9900155965,BR - 000211 / 30-Sep-2020CBR - 004118 / 29-Jan-2021Rtgs - 000267 / 02-Feb-2021,1172000,1051080,120920
373930,197-19-000030,Providing Drinking water through Drilling of New Borewells and pipeline work in ward no 197,Shashi Naik9900155965,BR - 000222 / 05-Oct-2020CBR - 004121 / 29-Jan-2021Rtgs - 000267 / 02-Feb-2021,1749200,1589262,159938
387047,197-17-000052,Providing drinking water works in Ward No 197 Vasanthpura ,Sri V Venkataraju9880813801,BR - 000294 / 02-Dec-2020CBR - 004305 / 16-Feb-2021Rtgs - 000277 / 23-Feb-2021,2218000,1993494,224506
391100,197-20-000002,Providing Concrete road. drain at Shani Mahatma Temple and surrounding areas in Vasanthpura Ward 197,M/s KRIDL9480828220,BR - 000322 / 11-Dec-2020CBR - 004946 / 11-Mar-2021Rtgs - 000295 / 12-Mar-2021,9784500,8848360,936140
391121,197-20-000011,Improvements to drain. culverts at AK colony Konankunte behind Kairuchi hotel in Ward 197,M/s KRIDL9480828220,BR - 000323 / 11-Dec-2020CBR - 004947 / 11-Mar-2021Rtgs - 000295 / 12-Mar-2021,9896900,8962215,934685
391053,197-20-000001,Providing Concrete road at Vasanthpura Govt school. Samudhaya Bhavan road and surrounding areas in Ward 197,M/s KRIDL9480828220,BR - 000324 / 11-Dec-2020CBR - 004948 / 11-Mar-2021Rtgs - 000295 / 12-Mar-2021,9896800,8963410,933390
337098,197-20-000030,Providing Asphalting to main roads in Narayananagar 1st Block in Ward No 197 Annex 02 Sl No 829,M/s KRIDL9480828220,BR - 000076 / 08-Jun-2020CBR - 005431 / 25-Mar-2021Rtgs - 000305 / 25-Mar-2021,19545000,17796850,1748150
337092,197-20-000031,Providing Asphalting to main roads in Narayananagar 3rd Block in Ward No 197 Annex 02 Sl No 830,M/s KRIDL9480828220,BR - 000077 / 08-Jun-2020CBR - 005432 / 25-Mar-2021Rtgs - 000305 / 25-Mar-2021,19543000,17759990,1783010
337880,197-20-000033,Improvements to roads and drains in Subbaraju layout and Ganesha Temple road Doddakalsandra of Ward NO 197 Annex 02 Sl No 832,M/s KRIDL9480828220,BR - 000078 / 08-Jun-2020CBR - 005433 / 25-Mar-2021Rtgs - 000305 / 25-Mar-2021,9775000,8883750,891250
402489,197-20-000009,Construction of RCC drain. culvert and other works at Vasanthpura Guttee in Ward No 197,M/s KRIDL9480828220,BR - 000406 / 29-Jan-2021CBR - 005178 / 23-Mar-2021Rtgs - 000306 / 25-Mar-2021,9885200,8977085,908115
410010,197-20-000007,Providing concrete road. drain behind JSS school at Konankunte in Ward No 197,M/s KRIDL9480828220,BR - 000449 / 20-Feb-2021CBR - 005180 / 23-Mar-2021Rtgs - 000306 / 25-Mar-2021,9899000,9208650,690350
337915,197-20-000035,Improvements to roads and drains to Vallabhanagar main road and Surrounding areas in Ward No 197 Annex 02 Sl No 834,M/s KRIDL9480828220,BR - 000084 / 15-Jun-2020CBR - 005450 / 25-Mar-2021Rtgs - 000308 / 26-Mar-2021,9774000,8884820,889180
352255,197-20-000024,"Providing Consultancy Services for Preparation of Detailed Project Report (DPR) for the works of (1) Comprehensive Development of roads and drains in Kuvempunagara and surrounding areas in ward no 197 Vasanthapura (GO Sl No: 823) (2) Providing Asphalting to main roads in Narayananagar 1st Block in Ward No 197, (GO Sl No 829) (3) Improvements to roads and Drains in Sharadhanagar of Ward No 197 (GO Sl No 828) & (4) Improvements to roads and drains to Vallabhanagar main road & Surrounding areas in Ward No 197 (GO Sl No 834)",Civil Infra Tech Consultancy8792240464,BR - 000137 / 20-Jul-2020CBR - 005714 / 28-Mar-2021Rtgs - 000319 / 29-Mar-2021,450000,405000,45000
352267,197-20-000025,"Providing Consultancy Services for Preparation of Detailed Project Report (DPR) for the works of (1) Improvements of roads and Drains in Maruthi layout of Ward No 197 (GO Sl No: 824) (2) Improvements to roads and drains in VV Nagar 2nd Block of Ward No 197, (GO Sl No 827) (3) Improvements of roads and Drains in BSK 5th Stage of Ward No 197 (GO Sl No 825) & (4) Improvements to roads and drains in PNB Layout an Jai Kumar Layout of Ward No 197 (GO Sl No 831)",M/s Civil Infra Tech Consultancy8792240464,BR - 000138 / 20-Jul-2020CBR - 005715 / 28-Mar-2021Rtgs - 000319 / 29-Mar-2021,450000,405000,45000
208909,197-18-000023,"Improvements CC Road, Drain at Vasantapura Guttae and Surrounding area in Ward No-197",Sri H C Umesh9113949787,BR - 000323 / 30-Nov-2018CBR - / Rtgs - 000007 / 22-Apr-2021,5728000,5059844,668156
410447,197-19-000028,Improvements and Maintenance of Burrial Ground Vasanthapura Ganapathipura in ward no 197,Rama V7411153374,BR - 000459 / 26-Feb-2021CBR - / Rtgs - 000014 / 30-Apr-2021,432600,397134,35466
217554,197-18-000038,Providing Street Name Boards and Ornamental Boards in Ward Limit in Ward No-197,Sri Somashekar G9902833363,BR - 000353 / 31-Dec-2018CBR - / Rtgs - 000023 / 07-May-2021,4995400,4422846,572554
217371,197-17-000023,Improvements and Asphalting to Sarvabhoma Nagar in ward no 197 Vasanthapura,"M/s Vrushab Infrastructure, Prop. Sri B K Mahesh Reddy9902963559",BR - 000354 / 31-Dec-2018CBR - / Rtgs - 000023 / 07-May-2021,5913400,5139154,774246
218025,197-18-000036,"Improvements CC Road, Drain at Kounakuntae Cross and Surrounding areas in Ward No-197",Sri Yogananda9845710489,BR - 000358 / 31-Dec-2018CBR - / Rtgs - 000023 / 07-May-2021,6356500,5586792,769708
217364,197-17-000011,"Improvements to drains and roads at 1st A cross Hemavathi road, Sumukha layout in ward no.197 Vasanthapura",M/s Vrushab Infrastructure9902963559,BR - 000355 / 31-Dec-2018CBR - / Rtgs - 000030 / 13-May-2021,2907600,2520478,387122
240316,197-18-000051,Sinking of New Borewell to provide drinking water in ward no.197 Vasanthapura,Sri Somashekar Gangadaraiah9902833363,BR - 000447 / 30-Mar-2019CBR - / Rtgs - 000038 / 21-May-2021,3917000,3501304,415696
240311,197-18-000015,Sinking of New Borewells and Providing Water Supply in Ward No-197,Sri Somashekar G9902833363,BR - 000448 / 30-Mar-2019CBR - / Rtgs - 000038 / 21-May-2021,1921800,1715422,206378
240300,197-18-000041,Drilling of borewells in ward no. 197,Somashekar G9902833363,BR - 000449 / 30-Mar-2019CBR - / Rtgs - 000038 / 21-May-2021,2449000,2191628,257372
240294,197-18-000062,Providing Borewell and Water Supply line in ward no.197 Vasanthapura,Sri Somashekar G9902833363,BR - 000450 / 30-Mar-2019CBR - / Rtgs - 000038 / 21-May-2021,2921000,2609790,311210
223161,197-18-000002,Providing Fencing to BBMP Property at Narayana Nagara in ward no 197 Vasanthapura,M/s KRIDL9886631704,BR - 000380 / 31-Jan-2019CBR - / Rtgs - 000056 / 02-Jun-2021,9982740,8674166,1308574
223711,197-18-000034,"Improvements CC Road, Drain at Thimmanna Layout and Surrounding areas in Ward No-197",Sri H B Boregowda9900155965,BR - 000383 / 31-Jan-2019CBR - / Rtgs - 000056 / 02-Jun-2021,2736850,2401483,335367
223529,197-18-000032,Improvements to Drain and Asphalting at Kuvempunagar in Ward No-197,Sri Prakash9538672091,BR - 000389 / 31-Jan-2019CBR - / Rtgs - 000056 / 02-Jun-2021,4174000,3654704,519296
225691,197-18-000037,Improvements to and Asphalting at Adarshanagar 1st Main in Ward No-197,Sri Thimme Gowda9740789326,BR - 000400 / 05-Feb-2019CBR - / Rtgs - 000067 / 08-Jun-2021,1913170,1671890,241280
426575,197-20-000076,Improvements to roads and Footpath at Maruthi Layout and Banashankari 5th Stage Layout in ward no 197 Vasanthapura,"K Satish, M/s Pritham Construction9886631704",BR - 000052 / 19-May-2021CBR - / Rtgs - 000088 / 23-Jun-2021,4824200,4361340,462860
238216,197-18-000060,Improvements to drains and Asphalting at V.V.Nagara 3rd block in ward no.197 Vasanthapura,V L Muniraj9986072837,BR - 000001 / 04-Apr-2019CBR - / Rtgs - 000100 / 05-Jul-2021,1745000,1525220,219780
238243,197-18-000058,Providing Asphalting to Venkatareddy layout in ward no.197 Vasanthapura,V L Muniraj9986072837,BR - 000002 / 04-Apr-2019CBR - / Rtgs - 000100 / 05-Jul-2021,1841000,1610159,230841
368159,197-20-000040,Providing Asphalting to Bank officers layout 3rd Stage Doddakalsandra in ward no 197 Annex 02 Sl No 918,M/s KRIDL9480828220,BR - 000286 / 30-Nov-2020CBR - / Rtgs - 000125 / 29-Jul-2021,9773500,8786655,986845
368128,197-20-000037,Providing Asphalting to Kuvempunagar Main road from Gokulam Apartment to Kanakapura main road (1st Main) in ward no 197 Annex 02 Sl No 915,M/s KRIDL9480828220,BR - 000287 / 30-Nov-2020CBR - / Rtgs - 000125 / 29-Jul-2021,9775600,8782308,993292
368059,197-20-000038,Improvements to drains and Culvert at Kuvempunagar Main road from Gokulam Appartment to Kanakapura Main road (1st Main) in ward no 197 Annex 02 Sl No 916,M/s KRIDL9480828220,BR - 000289 / 30-Nov-2020CBR - / Rtgs - 000125 / 29-Jul-2021,9770500,8803565,966935
367065,197-20-000037,"Providing Consultancy Services for Preparation of Detailed Project Report (DPR) for the works of (1) Providing Asphalting to Kuvempunagar Main road from Gokulam Apartment to Kanakapura main road (1st Main) in ward no 197 (GO Sl No 915) (2) Improvements to drains & Culvert at Kuvempunagar Main road from Gokulam Appartment to Kanakapura Main road (1st Main) in ward no 197 (GO Sl No 916) (03) Providing Asphalting to Bank Offices layout 1st Stage Doddakalsandra in ward no 197 (GO Sl No 917) (04) Providing Asphalting to Bank officers layout 3rd Stage Doddakalsandra in ward no 197 (GO Sl No 918), (05) Improvements to C C roads and Drains at Ganapathipura 1st to 6th Cross in ward no 197 (GO Sl No 919)","M/s VSR Civil Infra Pvt Ltd,9845230975",BR - 000316 / 10-Dec-2020CBR - / Rtgs - 000125 / 29-Jul-2021,420000,378000,42000
391727,197-20-000027,"Providing Consultancy Services for Preparation of Detailed Project Report (DPR) for the works of (1) Improvements of roads and Drains in Vittalanagar of Ward No 197 (GO Sl No: 826) (2) Providing Asphalting to main roads in Narayananagar 3rd Block in Ward No 197, (GO Sl No 830) (3) Improvements to roads and drains in Subbaraju layout and Ganesha Temple road Doddakalsandra of Ward NO 197 (GO Sl No 832) & (4) Improvements to roads and Drains in Siddanna layout and Vallabhanagar of Ward NO 197 (GO Sl No 833)",M/s Civil Infra Tech Consultancy8792240464,BR - 000333 / 15-Dec-2020CBR - / Rtgs - 000125 / 29-Jul-2021,450000,405000,45000
391684,197-20-000034,Improvements to roads and Drains in Siddanna layout and Vallabhanagar of Ward NO 197 Annex 02 Sl No 833,M/s KRIDL9480828220,BR - 000334 / 15-Dec-2020CBR - / Rtgs - 000125 / 29-Jul-2021,9771000,8896230,874770
368093,197-20-000039,Providing Asphalting to Bank Offices layout 1st Stage Doddakalsandra in ward no 197 Annex 02 Sl No 917,M/s KRIDL9480828220,BR - 000288 / 30-Nov-2020CBR - / Rtgs - 000128 / 30-Jul-2021,9774400,8782192,992208
246137,197-18-000029,Improvements to Roads and Asphalting at Siddanna Layout Venkat School Road and Surrounding areas in Ward No-197,H B Boregowda9900155965,BR - 000062 / 17-May-2019CBR - / Rtgs - 000130 / 02-Aug-2021,6779000,5976146,802854
426560,197-20-000006,Providing concrete road at AK colony Konankunte behind Kairuchi Maheshwaramma temple crosses in Ward No 197,M/s KRIDL9480828220,BR - 000056 / 21-May-2021CBR - / Rtgs - 000133 / 02-Aug-2021,9897850,9179050,718800
423897,197-19-000033,Improvements to roads and Footpath at Vasanthapura ward juridiction in ward no 197,M Ravi Bhushan8618082207,BR - 000042 / 06-May-2021CBR - / Rtgs - 000144 / 06-Aug-2021,1140000,1032252,107748
392279,197-20-000029,"Providing Consultancy Services for Preparation of Project Management Consultancy (PMC) for the works of (1) Comprehensive Development of roads and drains in Kuvempunagara and surrounding areas in ward no 197 Vasanthapura (GO Sl No: 823) (2) Providing Asphalting to main roads in Narayananagar 1st Block in Ward No 197, (GO Sl No 829) (3) Improvements to roads and Drains in Sharadhanagar of Ward No 197 (GO Sl No 828) & (4) Improvements to roads and drains to Vallabhanagar main road & Surrounding areas in Ward No 197 (GO Sl No 834)",M/s Unique Engineering and Management Consultancy9738120334,BR - 000408 / 29-Jan-2021CBR - / Rtgs - 000196 / 16-Sep-2021,480000,432000,48000
392239,197-20-000026,"Providing Consultancy Services for Preparation of Project Management Consultancy (PMC) for the works of (1) Improvements of roads and Drains in Maruthi layout of Ward No 197 (GO Sl No: 824) (2) Improvements to roads and drains in VV Nagar 2nd Block of Ward No 197, (GO Sl No 827) (3) Improvements of roads and Drains in BSK 5th Stage of Ward No 197 (GO Sl No 825) & (4) Improvements to roads and drains in PNB Layout an Jai Kumar Layout of Ward No 197 (GO Sl No 831)",M/s Unique Engineering and Management Consultancy9738120334,BR - 000409 / 29-Jan-2021CBR - / Rtgs - 000196 / 16-Sep-2021,480000,432000,48000
392284,197-20-000031,"Providing Consultancy Services for Preparation of Project Management Consultancy (PMC) for the works of (1) Improvements of roads and Drains in Vittalanagar of Ward No 197 (GO Sl No: 826) (2) Providing Asphalting to main roads in Narayananagar 3rd Block in Ward No 197, (GO Sl No 830) (3) Improvements to roads and drains in Subbaraju layout and Ganesha Temple road Doddakalsandra of Ward NO 197 (GO Sl No 832) & (4) Improvements to roads and Drains in Siddanna layout and Vallabhanagar of Ward NO 197 (GO Sl No 833)",M/s Unique Engineering and Management Consultancy9738120334,BR - 000410 / 29-Jan-2021CBR - / Rtgs - 000196 / 16-Sep-2021,480000,432000,48000
392246,197-20-000038,Providing Consultancy Services for Preparation of Project Management Consultancy (PMC) for the works of (1) Providing Asphalting to Kuvempunagar Main road from Gokulam Apartment to Kanakapura main road (1st Main) in ward no 197 (GO Sl No 915) (2) Improvements to drains & Culvert at Kuvempunagar Main road from Gokulam Appartment to Kanakapura Main road (1st Main) in ward no 197 (GO Sl No 916) (03) Providing Asphalting to Bank Offices layout 1st Stage Doddakalsandra in ward no 197 (GO Sl No 917) (04) Providing Asphalting to Bank officers layout 3rd Stage Doddakalsandra in ward no 197 (GO Sl No 918),M/s Unique Engineering and Management Consultancy9738120334,BR - 000411 / 29-Jan-2021CBR - / Rtgs - 000196 / 16-Sep-2021,320000,288000,32000
397071,197-20-000043,Providing Consultancy Services for Preparation of Project Management Consultancy (PMC) for the works of (1) Improvements to C C roads and Drains at Ganapathipura 1st to 6th Cross in ward no 197 (GO Sl No 919) (02) Improvements to C C roads and drains at Ganapathipura 6th to 11th Cross in ward no 197 (GO Sl No 920) (03) Providing Asphalting with improvements to drain at Vasanthapura Best Company layout roads in ward no 197 (GO Sl No 921) (4) Providing Asphalting to 1st Main Sarvabhoumanagar & Improvements to drain at 2nd Main Doctors colony Chikkalasandra in ward no 197 (GO Sl No 923) (05) Improvements to drains & Culvert at Anjaneyya HBCS Layout in ward no 197 (GO Sl No 924),M/s Unique Engineering and Management Consultancy9738120334,BR - 000412 / 29-Jan-2021CBR - / Rtgs - 000196 / 16-Sep-2021,400000,360000,40000
447416,197-20-000078,Construction of Box culvert at Narayana Nagar near Ramya Garden in Vasanthapura ward no 197,M/s Loukya Constructions8150913165,BR - 000055 / 31-Jul-2021CBR - / Rtgs - 000199 / 17-Sep-2021,771680,716800,54880
403319,197-20-000045,Providing Asphalting to 1st Main Sarvabhoumanagar and Improvements to drain at 2nd Main Doctors colony Chikkalasandra in ward no 197 Annex 02 Sl No 923,M/s KRIDL9480828220,BR - 000446 / 19-Feb-2021CBR - / Rtgs - 000218 / 01-Oct-2021,9775100,8780835,994265
403341,197-20-000042,Improvements to C C roads and drains at Ganapathipura 6th to 11th Cross in ward no 197 Annex 02 Sl No 920,M/s KRIDL9480828220,BR - 000447 / 19-Feb-2021CBR - / Rtgs - 000218 / 01-Oct-2021,9775500,8780715,994785
403374,197-20-000044,Comprehensive Development to roads and drains at Brightway layout Gowdanpalya roads in ward no 197 Annex 02 Sl No 922,M/s KRIDL9480828220,BR - 000461 / 04-Mar-2021CBR - / Rtgs - 000218 / 01-Oct-2021,9773000,8779390,993610
266694,197-18-000035,"Construction of RCC Drain, Culvert and Improvements to Roads at Doddakalsandra Village Surrounding areas in Ward No-197",Sri H B Boregowda 9900155965,BR - 000120 / 02-Aug-2019CBR - / Rtgs - 000233 / 08-Oct-2021,6612450,5812980,799470
273720,197-19-000050,Providing Assured Minimum Facilities (AMF) to all polling Stations of Lokasabha Elections 2019 pertains to ward no 197,Santhosh Naik9986781728,BR - 000151 / 30-Aug-2019CBR - / Rtgs - 000239 / 11-Oct-2021,367640,352715,14925
256831,197-17-000024,Improvements and Asphalting to Vallabha nagar in ward no 197 Vasanthapura,Sri Prateek K R9916997189,BR - 000144 / 26-Aug-2019CBR - / Rtgs - 000239 / 11-Oct-2021,4615600,4030248,585352
256842,197-17-000025,Improvements to roads and asphalting at Siddanna layout Vallabha nagarin ward no 197 Vasanthapura,Sri Prateek K R9916997189,BR - 000145 / 26-Aug-2019CBR - / Rtgs - 000239 / 11-Oct-2021,4604000,4019726,584274
256754,197-17-000020,Improvements and Asphaltingat Abi Naidu layout to Behind Khodays Factory in ward no 197 Vasanthapura ,Sri Prateek K R9916997189,BR - 000146 / 26-Aug-2019CBR - / Rtgs - 000239 / 11-Oct-2021,3628000,3166344,461656
256776,197-17-000027,Improvements and Asphalting to DAV Public School road at nagara in ward no 197 Vasanthapura,Sri Prateek K R9916997189,BR - 000147 / 26-Aug-2019CBR - / Rtgs - 000239 / 11-Oct-2021,4497000,3927496,569504
274377,197-19-000040,Improvements to CC roads and Drain at Vittalnagar 2nd Stage in Ward No. 197,Yogananda9845710489,BR - 000153 / 31-Aug-2019CBR - / Rtgs - 000243 / 13-Oct-2021,3450000,3031192,418808
275031,197-19-000047,Improvements to Roads and Drain at Manjunathanagar 1st and 2nd Main and Cross Roads in Ward No. 197,"K Sathish, M/s Preetham Constructions9886631704",BR - 000163 / 31-Aug-2019CBR - / Rtgs - 000243 / 13-Oct-2021,2580200,2276514,303686
275003,197-19-000017,Improvements to road and drain Behind 17th main Park at Doddakalsandra village in ward no 197,K Sathish M/s Preetham Constructions9886631704,BR - 000162 / 31-Aug-2019CBR - / Rtgs - 000243 / 13-Oct-2021,4625700,4087033,538667
446329,197-16-000001,Annual Operation and Maintenance of street lighting system in ward no-197 Package B14 of Bommanahalli zone.,M/s Sri Venkateswara Electricals9945811466,BR - 000022 / 29-Jul-2021CBR - / Rtgs - 000246 / 13-Oct-2021,778225,679778,98447
446330,197-20-000047,Annual Operation and Maintenance of street lighting system in ward no-197 Package B16 of Bommanahalli zone,M/s.Sri Venkateswara Electricals 9448679666,BR - 000023 / 29-Jul-2021CBR - / Rtgs - 000246 / 13-Oct-2021,1047989,974895,73094
367047,197-20-000042,Providing Consultancy Services for Preparation of Detailed Project Report (DPR) for the works of (1) Improvements to C C roads and drains at Ganapathipura 6th to 11th Cross in ward no 197 (GO Sl No 920) (02) Providing Asphalting with improvements to drain at Vasanthapura Best Company layout roads in ward no 197 (GO Sl No 921) (03) Providing Asphalting to 1st Main Sarvabhoumanagar & Improvements to drain at 2nd Main Doctors colony Chikkalasandra in ward no 197 (GO Sl No 923) (04) Improvements to drains & Culvert at Anjaneyya HBCS Layout in ward no 197 (GO Sl No 924),"M/s VSR Civil Infra Pvt Ltd,9845230975",BR - 000315 / 10-Dec-2020CBR - / Rtgs - 000252 / 25-Oct-2021,335000,301500,33500
422839,197-20-000023,Comprehensive Development of roads and drains in Dr. Ambarish Layout in ward no 197. Development of play ground in RBI Layout of ward no. 195. Construction of model road at Vishwapriya layout in ward no 192. Improvement and development of parks in ward no 195. Annex 02 Sl. No 524. 896. 518. 836 and 897,SAANVI EARTH MOVERS 9900007121,BR - 000038 / 05-May-2021CBR - / Rtgs - 000252 / 25-Oct-2021,20504200,19200870,1303330
369719,197-19-000044,Maintanence of Water Supply System in BBMP Jurdiction in Ward No. 197,BOREGOWDAHB9900155965,BR - 000207 / 28-Sep-2020CBR - / Rtgs - 000302 / 04-Jan-2022,1995000,1815679,179321
467000,197-20-000013,Improvements to drain with asphalting at Manjunathnagar of Vasanthpura,KRIDL BHUSIRI ACCOU0000000000,BR - 000200 / 22-Oct-2021CBR - / Rtgs - 000346 / 16-Feb-2022,9893600,8934148,959452
467050,197-20-000005,Improvements to roads and drains at Vajpayee Nagara and surrounding areas in Vasanthpura in Ward No.197,KRIDL BHUSIRI ACCOU0000000000,BR - 000201 / 22-Oct-2021CBR - / Rtgs - 000346 / 16-Feb-2022,9891400,8981102,910298
430175,197-20-000032,Improvements to roads and drains in PNB Layout an Jai Kumar Layout of Ward No 197 Annex 02 Sl No 831,KRIDL BHUSIRI ACCOU0000000000,BR - 000068 / 05-Jun-2021CBR - / Rtgs - 000352 / 16-Feb-2022,5554000,4991620,562380
279845,197-19-000006,Improvements to drain and culvert at Nisarga Layout 5th and 6th cross in ward no 197,S S ENTERPRISES9845385296,BR - 000182 / 25-Sep-2019CBR - / Rtgs - 000378 / 24-Feb-2022,3515000,3074432,440568
473127,197-20-000077,Improvements to Park at Narayana Nagara in ward no 197 Vasanthapura, PRITHAM CONSTRUCTIO9886631704,BR - 000210 / 08-Nov-2021CBR - / Rtgs - 000385 / 02-Mar-2022,7300000,6823342,476658
372356,197-19-000049,Providing Water Supply through Water Tankers in Ward Jurdiction in Ward No. 197,RAJANNA M9945383002,BR - 000212 / 30-Sep-2020CBR - / Rtgs - 000424 / 24-Mar-2022,993450,921842,71608
